ab: av
abçı: avcu
abınç: teselli, rahat, sükunet
abla-: avlamak
aç: aç, karnı tok değil
aç-: açmak
aça: akrabalık ifade eden bir söz
açden: (?)
açu: baba (Tanrıya hitaben kullanılır)
adak: ayak
adakı: babacığım manasında sevgi ifade eden bir söz
adaklıg: ayaklı
adartu: tehlikeli
adaş: arkadaş, dost
adgır: aygır
adıg: ayı
adınçıg: başka, diğer, ayrı
adır-: ayırmak
adırıl-: ayrılmak, ölmek
adırın-: ayrılmak
ag-: aşmak, çıkmak
agan: itikâf
agar: bkŋz; agır
agı: "çinden gelen ipekli kumaş", hediye, define, hazine
agı-: püskürtmek
agıl: ağıl
agıl-: yükselmek
agır: ağır, değerli
agırçak: ağırsak
agış: yükseliş, yokuş
agıt-: çıkarmak, belirtmek
agız: ağız
agla-: ağlamak
agrı-: hastalanmak
agtur-: çıkartmak (yukarı), aşdırmak
agulug: zehirli
al-: almak
ala: ala, alaca
aldız-: (?)
alg-: yok etmek
alp: yiğit, kahraman, cesur, zorlu
alpagu: rütbe, "ünvan", bir memuriyet
ba-: bağlamak, rabtetmek
bag: bağ, müttefik, müttehid
baga: bir rütbe, ünvan
bayır: bakır
bagış: boğum (parmak, kamış gibi şeylerin)
balbal: ölünün öldürülen düşmanı adına dikilen taş
balık: kent
ban-: bağlamak
baŋa: bana
bar: var
bar-: varmak, gitmek
barça: bütün, hep
barım: mal, mülk
bark: bark, ev bark
bars: pars
bas-: basmak, ansızın hücum etmek
basın-: çökmek, basınmak, kahrolmak
basıt-: basdırmak, ansızın hücum etmek
baş: baş, başı (dağ veya pınarların)
başad-: riyasete geçirmek, başa geçirmek
başla-: idare etmek, riyaset etmek, başa geçmek
başlan-: başlanmak
başlıg: başlı
bat: hemen, derhal, çabuk
bat-: batmak
batım: batım
batısık: batı, garp
batur: batır, kahraman
bay: zengin
bay-: bağlamak, ipe vurmak
baz: muti, garib, garip, yabancı
bediz: nakış, tasvir, nârin
bediz-: süslemek, resm etmek, tasvir etmek, nakşetmek
bedizçi: nakkaş, sanatkâr, heykeltraş
bedizle-: süslemek
bedük: büyük
beg: beğ
begdeme: cennet
beglik: beğli, beği olan
begni: buğday, darı, arpa gibi şeylerden yapılan içki
bel: bel
Çocuk Böri Saŋun: özel ad
eçü apa: ced, ecdad
ėçü apa: ced, ecdad
küŋ: cariye
küŋed-: cariye kılmak
kalıŋsız: cihazsız, kalımsız
kıyın: ceza, tenbih, tevbih
yagak: ceviz
yagaklıg: cevizli, yapraklı
yamgılıg: ceman, topdan, müctemian
yug: cenaze merasimi, Kâşgari aynı sözü definden sonra muayyen zamanda yapılan ölü yemeği diye izah ediyor
yugla-: cenaze merasimi yapmak
yuglat-: cenaze merasimi yapdırmak
ança: bunca, bu kadar, böyle, şöyle
ançıp: böyle, böylece
andalıg: böylece, öyle
aramakçı: sihirbaz, kurnaz, aldatıcı
arkış: kervan, haberci, mektup
aşnukı: önceki, evvelki
bėrgerü: beriye doğru, cenuba doğru
bėriden: beriden, cenubdan
bėriye: beriye, cenubta
bėşinç: beşinci
bir yėgirminç: on birinci
bol-: olmak (yardımcı fiil)
bolug: varlık, mevcudiyet
bök: zaviye, köşe, bucak
çab: şöhret, şöhretli, şan, şanlı, meşhur
çat: kuyu
çerig: ordu, asker, çeri
çıgany: fakir, yoksul
çından: kokulu ağaç, sandal ağacı
çıkan: çin
çıt: kamıştan yapılan kulübe, çit, sınır
çorak: çorak
çök: tanrıya karşı yapılan bir hitab
çöl: çöl
çölig: çöllü
çulbu: efsun, sihir
Çaŋsı: özel ad
Çekül: özel ad
Çigil: kavim veya yer adı
Çigşi: özel ad
Çik: Kögmen ormanlarında oturan Türk kavmi
Çik Bilge Çigşi: özel ad
Çikşin: özel ad
Çiner: özel ad
Çıgıltır Köl: göl adı
Çıkan Tonyukuk: özel ad
Çugay: Hangay dağ ormanları, bir bitki adı
Çugay Kuz: yer adı
Çor: rütbe, ünvan, özel adların soŋuna eklenir
Çuş: ırmak adı
dintar: dini ayin icra eden
anda: orada
andag: öyle, o kadar
bod: boy, ittihad, birleşme, birlik
böd: taht
budlulug: hayvanların burnuna takılan halka
budun: kavim, millet
budunlıg: kavimli, milletli
buŋad-: kederlenmek, müteessir olmak
bunda: burada, buraya
edgü: iyi
edgüti: iyice
edük: ayak kabı, papuç
erdem: edep, fazilet, terbiye
erdemlig: terbiyeli, faziletli, meharetli
ėşid-: işitmek
idi: sahib, efendi
idisiz: sahibsiz, efendisiz
idiş: kadeh, bardak
eb: ev, oturulan yer, yurd, vatan
eble-: evlendirmek
eçin-: kerem kılmak, doyumluk vermek
eg-: kurban etmek
egiç: kız çocuğu için sevgi eseri olarak kullanılır
egin: dam, sırt, omuz
egir-: kuşatmak, çevirmek
egit: hizmetçi kadın
egmiç: karı, zevce
egrit-: sarfetmek, harcamak
eke: abla, büyük kız kardeş
ekinlig: ekinlik, ekilen
ekinti: ikinci
elgin: yolcu, misafir
elig: el
elik: ehli olmayan, yabani
elt-: getirmek, iletmek
emgek: emek, mihnet
emget-: emek çekdirmek, zahmet vermek, yormak
emig: meme, şifa
emsı-: emmek istemek
eŋilik: en ilk, en evvel
eŋle-: avlamak
er: er, erkek, adam
er-: imek, olmak
erig: becerikli, çalışkan
erklig: kudretli, nüfuzlu, sözü geçer, mukadderat
erksiz: kudretsiz, kuvvetsiz, nüfuzusuz
erk: kudret, nüfuz, sözü geçerlik
erteŋü: fevkalade, son derece
ertür-: yaptırmak, oldurmak
esen: sağ
esri: tekir renk, kaplan rengi, iki renkli
asıg: fayda, kazanç
anyıg: fena, kötü
ırk: fal
opla-: fırlamak
karamıg: fena ruh
yabız: fena, yavuz, kötü
yablak: fena, kötü
yoluk: feda
yoluka-: feda olmak
artuk: artık, fazla
bor: bora, fırtına
buluŋ: taraf, köşe
buŋsız: kesretle, mebzulen, fazlasile
ėlçi: elçi, sefir, başbuğ
ėr-: olmak, imek fiili
iniyigün: akrabalık ifade eden bir söz
iş: eş, arkadaş, müteffik
iyü: i- fiilinden, bir nida eki gibi
ıça: akrabalık ifade eden bir söz
ıyu: nida eki, iy- fiilinden
keŋren-: hafif ses çıkarmak
garatıt-: yapdırtmak, vücude getirtmek
altı yėgirmi: on altı
altunlıg: altunlu
amga: tahsıldar
artıglat-: çoğaltmak, teksir etmek
atlıg: adlı, isimli
ayguçı: müşavir, danışman
aylıg: aylık
azıg: azı dişi
alt: alt, aşağı
aŋaru: ona doğru, ona karşı
arkar: dişi dağ keçisi
art: dağ yolu, dağ beli
asra: aşağı, alt
beltir: yol ağzı, yolların birleştiği yer
boguz: boğaz
boguzlan-: boğazlanmak
bozagu: buzağı
bozagula-: buzağılamak, buzağı doğurmak
buka: boğa
bukarsı: köstek, bukağı
butula-: erkek yavru doğurmak (deve)
buymul: bir nevi terbiye kabul etmez, hayırsız doğan, boynu beyaz hayvan
bük: ağaçlık, ormanlık
ėçi: ağabey, büyük erkek kardeş, amca
içi: ağabey, büyük erkek kardeş
alku: hep, herkes
bilge: hakim, bilgili, akıllı
bilgelig: hakim olan, bilge olan
bögi: hakim, akıllı, bilgili
köni: hased
körüg: haberci
ogrı: hırsız
okın: hepsi, temamile
ö-: hatırlamak
kadaş: hısım, akraba
kagan: hakan, hükümdar
kaganla-: hakanlamak, hakan sahibi kılmak
kaganlıg: hakanlı, hakan sahibi
kagansıra-: hakansız olmak
kagansırat-: hakansız eylemek, hakandan mahrum kılmak
kalyur-: hiddetlenmek, kızmak
kamag: hep, bütün, tamamen
kan: han, rütbe veya derece olarak kagan'dan aşağı olan han
kanı: hani, nerede
kanlan-: hanlanmak, han sahibi olmak
kanlık: hanlık
karşı: hasım, karşı
kanyu: hangi, her kim, nerede
kılınç: huy, ahlak
kılınçlıg: huylu, ahlaklı
kop: hep, bütün, çok
sabçı: haberci, söz getiren
sayu: her, hep
süŋüş-: harpetmek, savaşmak
tapıg: hizmet
teblig: hilekar
teŋriken: hâkim, bilgili
üçürgü: halı, kilim
yabgu: hakandan sonra gelen bir rütbe olup bu rütbenin sahibi
yakala-: hudud tayin etmek, hududda oturmak, tanzim etmek, yaşamak
yarınça: harbe, mızrak
ıbar başı: ağaç, nebat
ıçgın-: kaybolmak, bozulmak
ıd-: göndermek, terketmek, bırakmak
ı (d) -: aynı mana
ıduk: mukaddes, kutsi, mübarek
ıdukluk: kudsiyet, kader
ıdukut: Basmıl kavminin reisinin ünvanı
ıgaç: ağaç
ıgar: gayrı, diğer, başka
ınagaru: istikamette yahut bütün, kamilen
ınanç: bir ünvan, rütbe, inanılan, itimad edilen
ınançlıg: inançlı, şayanı itimad
ırak: uzak, ırak
ıt: it, köpek
iç: iç, dahil
iç-: içmek
içgir-: itaat altına almak, girdirmek (içeri)
içik-: itaat etmek, teslim olmak
içili: büyük kardeşli
içreki: saraya mensub olanların bir rütbesi, saraydaki
igid: yalan, hata
igil: çok
igid-: beslemek, büyütmek, yetişdirmek, doğrultmak
iki: iki
iki biŋ: ikibin
iki elig: kırk iki
ikinti: ikinci
iki otuz: yirmi iki
iki yėgirmi: oniki
ikiz: ikiz
ilet-: götürmek, iletmek
ilin-: batmak, bulaşmak, ilişmek
ilgerü: ileri
ilki: ilki, birincisi
in-: inmek
inç: emin, mutmein
inçe: böylece
ingen: inen
ingek: inek
ini: küçük kardeş
inilgü: küçük kardeşli
inili: küçük kardeşli
ir: yer
irkek: erkek
irtür-: vazgeçmek
isigti: darı
isrek: sarhoş
urmızt: Jüpiter
lü: ejderha
kani: bakire
keç-: geçmek
keçigsiz: geçitsiz
keçür-: geçirmek
kedim: giyim, zırh
kedimlig: zırhlı, giyimli
kekük: süksük kuşu
kel-: gelmek
keliŋün: gelin
kelür-: getirmek
kem: kim
kentü: kendi
kerekü: çadır
kergek: gerek, lazım
kergeksiz: lüzumundan fazla
kes-: kesmek
keyik: av hayvanı, geyik
kez-: girmek (içeri), oymak
kėş: okluk, ok konulan şey, sadak
kėri: geri, garb
ki: arka, garb
kiçe: gece
kiçig: azıcık, küçücük
kidiz: keçe
kiŋsür: kıyam etmek
kir-: girmek
kisre: sonra
kiş: kakım
kişe-: kösteklemek, köstek vurmak
kişi: kişi, insan, zevce
kiyik: av hayvanı, geyik
kiwan: saturn yıldızı
köbrüge: davul
köçür-: göçürmek
kögür-: yaymak, tevsi etmek
kök: gök, mavi
kökmek: geyik cinsinden yabani bir hayvan
kök teyeŋ: gök sincap
köl: göl
köl-: bağlanmak, vurulmak
köŋek: kova, ibrik, matara
lagzın: domuz
Laçin Bayluk: özel ad
alka: al, kırmızı
alka-: medh etmek, sena etmek, takdis etmek
alkın-: yok olmak, bitmek, tükenmek
alkış: dua, alkış
altı: altı
altı otuz: yirmi altı
altı yüz: altı yüz
altmış: altmış
altun: altun
ançula-: arzı hürmet etmek, ta'zim etmek
aŋla-: anlamak
aŋlan-: anlanmak
aklat-: öne sevketmek, savmak, uzaklaştırmak
aralı: çalılık
arıl-: yorulmak, bitkin bir hale gelmek
maga: bir hayvan ismi
maŋa: bana
mar: üstad, hoca, muallim
men: ben
meŋ: gıda, yiyecek
meŋi: neşe, saadet
meŋile: eğlenmek, zevk almak, neşelenmek
meŋilig: şen, mesut, mesrur
meŋkü: ebedi, daimi
miŋ: bin
min-: binmek
munçuk: bonçuk, mücevher
muŋlug: azap verici, kederli
müçe: düğün hediyesi
mügüz: boynuz
müŋre: böğürmek
Makaraç: Mihrace
amrak: sevgili
amtı: imdi, şimdi
bėş tüman: ellibin
bėş yėgirmi: on beş
bėş yėtmiş: altmış beş
bir tümen: onbin, (10.000)
bir tümen artukı yėti biŋ: on yedibin, 10.000+7.000
bir yėgirmi: on bir
nagıd: venüs
ne: ne, nasıl, hangi
neçük: nasıl
negüde: nasıl, ne biçim
neke: neye, neden
nelük: neden
nençe: kaç, ne kadar
neŋ: şey, nesne, hiç
neŋnen: ne, her ne
ne teg: nasıl, ne gibi
nom: ahkâm (dini)
Neŋ Seŋün: özel ad
aŋ: av hayvanı, avlanmış hayvan
ana: ana
aŋar: onu, ona, orada
anı: onu
ayın-: korkmak, sakınmak, çekinmek
o: o, bu
oba: kabile, aşiret, boy
obut-: saklamak, gizlemek
odgur-: uyandırmak
oglan: oğul, evlat, oğlan
oglıt: oglan'ın cemi
ogul: evlat, çocuk
oguş: kabile, boy, soy
ol: o, bu
olıt-: oturmak
olur-: oturmak, tahta çıkmak
olurt-: oturtmak
on: on, 10
oŋ-: rengi solmak
on tümen: yüzbin, 100.000
onunç: onuncu
opul-: etrafını sarmak, etrafını çevirmek
ok: te'kid eki
okı-: çağırmak, davet etmek
oksız: teşkilatsız
ordu: karargah, hakanın oturduğu kent, paytaht
ortu: orta, yarı
ot: ot, nebat
otsuz: otsuz, nebatsız
otuz: otuz, 30
otuz artukı bir: otuz bir, 31
otuz artukı üç: otuz üç, 33
otuz artukı sekiz: otuz sekiz, 38
otuz artukı tokuz: otuz dokuz, 39
otuz artukı tört: otuz dört, 34
oyma: kumarcı
oyug: oyun, kumar
oz-: kurtulmak
öbkele-: öfkelenmek
öçeş-: kavga etmek, yarış etmek
öd: zaman, vakit
öd-: nasihat etmek, öğüt vermek
ödür: diğer, başka, öbür
ög: anne
ög-: öğmek, meth etmek
öge: büyük anne, kaynana
ögir-: memnun olmak, mesrur olmak
ögleş-: meşveret etmek, danışmak
ögrünç: sevinç, sürur
ögrünçülüg: sevinçli, mesrur
ögür: tavla, sürü
ögüş: çok
ögüş-: aşınmak
ök: aynı, tıpkı
ök-: toplamak, biriktirmek
ökül-: toplanmak, yığılmak
ökün-: pişman olmak, nadim olmak
ökünç: öğünme, medh
öküş: çok
öküz: öküz
öl-: ölmek
ölüg: ölü
ölügli: ölümlü
ölüm: ölüm
ölür-: öldürmek
ölüt-: öldürmek, ölüm vermek, öldürtmek
ömele-: emeklemek
öŋ: ön, şark, doğu
ön-: bitmek (ot), fışkırmak, çıkmak, gitmek
öŋi: ayrı, başka
öntür-: çıkarmak, bitirmek (nebat)
öŋüş-: yırtmak, bölmek, delmek
öpgük: ibibik kuşu, çavuş kuşu
örgi-: saray yapmak, konak kurmak
pagarlı: seyyare
paşik: istifham
piçin: maymun
apa: rütbe, ünvan, has isim
köpük: köpük
küp: küp, kap
kap-: kapmak
kop-: kopmak
sep-: birleştirmek, hazırlamak
şadapıt: ünvan, rütbe
tap-: tapmak, hizmet etmek
tapa: ...ya doğru, karşı, ...ye müteveccihen
tapla-: arzu etmek, muvafık bulmak
top-: bağlamak
topla-: toplamak
töpe: tepe
up-: içmek
yap-: yapmak
yapıt-: yapdırmak
yılpagut: bkŋz; alpagu
yıpar: misk
aksırak-: mükemmel, âlâ
ar-: yorulmak, dermansız kalmak
ara: ara, orta
ara-: aramak
ark: ark
arka: arka
arkuy: istihkâm
artat-: bozmak
artur-: aşırı gitmak, haddini aşmak
bėr-: vermek
sab: söz, laf
saç: saç
saç-: saçmak
sagdıç: sağdıç, dost
sagır: çayır
salla-: sal ile geçmek
san-: saymak
saŋa: sana
sanç-: saplamak, batırmak, mızraklamak
sansız: sayısız
sakın-: düşünmek
sarıg: sarı
satıgçı: satıcı
say-: saymak
seb-: sevmek
sebin-: sevinmek
sebret-: vazgeçirmek, boşaltmak, bitirmek
seg: uyanık, zeyrek, müteyakkız
sekiz: sekiz, 8
sekizinç: sekizinci
sekiz on: seksen, 80
sekiz kırk: otuz sekiz, 38
sekiz tümen: seksen bin, 80.000
sekiz yegirmi: on sekiz, 18
semiz: semiz
semrit-: semizlemek
sen: sen
silik: temiz, tatlı dilli, yakışıklı, pakize
sin: sen
siŋil: erkeğin küçük kız kardeşi
sir: müttehid
siz: siz
sı-: kırmak, hezimete uğratmak
sıg: sığ, derin olmayan
sıgıt: ağlayış
sıgıtçı: ağlayan, figan eden
sıgta-: ağlamak
sıgun: geyik
sın-: kırılmak
şad: ünvan, rütbe
şaş-: ayrılmak, çözülmek
şen-: binmek, sürmek
şmnu: şeytan
Şan: yer adı
Şanduŋ: Çin'deki Şan-tung eyaleti
Şaŋun: özel ad
Şıp Başı: bir ırmak ayağının adı
aş: aş, yemek
aş-: aşmak
aşa-: yemek yemek
aşsız: yemeksiz
bėş: beş
bėş otuz: yirmi beş
bėş kırk: otuz beş
bėş yüz: beş yüz
biş-: olmak, kemâle gelmek, yetişmek
boşan-: kurtulmak, serbest olmak
bosuşlug: elemli, kederli
boş: boş
buluş-: buluşmak
buşgur-: kışkırtmak
eş: eş, arkadaş zevce
tabar: davar
tabılku: spiraea altaica denilen nebat
tabışgan: tavşan
tag: dağ
tagık-: dağa çıkmak
talım: yırtıcı
talula-: seçmek, intihab etmek
taluy: deniz
tam: duvar
tamgaçı: damgacı, damga vuran, mühürdar
tamgala-: damgalamak
tamgalıg: damgalı, mühürlü
taŋ: tan, şafak
tan: vücud, ten
taŋla-: şafak sökmek, tanlamak
tanuklug: şahidlik, tanıklık
takı: dahi
takıyu: tavuk
tarıg: ekin
tarlag: tarla
tarkan: Türklerce maruf bir rütbe veya ünvan
tarkanç: asi, isyan eden
tarkat: tarkanın cemi
tartışmak: çekişmek, tartışmak
taş: taş
taşıgır-: dışarı çıkarmak
taşık-: dışarı çıkmak
tat: Türklere tabi olan yabancı kavim
tatıglıg: tatlı
tany: tay
taygun: büyükler, rical, rüesa
tebe: deve
teg: gibi, benzer
teg-: değmek, erişmek, varmak
tegi: değme, erişme
u: uyku
u-: muktedir olmak
uç: uç, cenah
uç-: uçmak, havalanıp gitmek, ölmek
uçruglug: uçlu, zirveli, son haddinde olan, son derece
uçuk: kuş, avcu kuşu
uçuz: kolay, basit
ud: ve
ud-: uymak, takib etmek, arkasından gitmek
udı: uyumak
udış-: bir bir arkasından takib etmek
udız-: sevketmek, idare etmek
udlık: oyluk
ugur: ugur, sâye, devlet
uguş: aşiret, kabile, klan, soy
ula-: bağlamak, bir araya getirmek, takib etmek, arkasından gelmek
ulga-: büyümek
ulgart-: büyütmek, çoğaltmak
ulug: ulu, büyük
ulus: ulus, halk, kavim, millet
una-: razı olmak, muvafakat etmek
unç: emin
unıt-: unutmak
ur-: vurmak, bindirmek, tayin etmek, tahkim etmek
urı: erkek evlâd
urılan-: erkek çocuk doğurmak, erkek çocuk sahibi olmak
urtur-: vurdurmak
urug: kabile, soy, klan
urugsırat-: soysuz kılmak
uruŋ: bir rütbe, memuriyet
uruş: vuruş, harp, savaş
usıç: tehlikeli
us: kuyruk sokumu, atın kuyruğu
ut: öküz
ut-: yutmak, galib gelmek, kazanmak
utru: karşı, ...ya doğru
utuz-: yutulmak, kaybetmek
uy-: basıp sıkışdırmak, nüfuz sahibi olmak
uya: kardeş, hısım
ü-: yığmak, birikdirmek
üç: üç
üç biŋ: üç bin
üç elig: kırk üç
üç otuz: yirmi üç
üç tümen: otuz bin
üçün: için
üçünç: üçüncü
üç yėgirmi: on üç
üge: yaşlı, tecrübeli, akıllı, teginler'den daha aşağı olan ve halkın yaşlı, tecrübelisine verilen ünvan
ügüz: ırmak, ırmak
ülken: yüksek, büyük
ülüg: nasib, tali, pay, hisse
ün: şöhret, şan, ün
ürk-: ürkmek
ürkit-: ürkütmek
üz-: kesmek, koparmak, parçalamak
üze: üstünde, üstde, yukarıda
üzen-: üzenmek
üzük: yırtık
Üç Birkü: Urga'nın kuzey batısında bir ırmak, yer adı
Üçin Külüg Tirig: özel ad
vidaŋ: tazyik
ėlteber: vali, idare amiri
tokı-: vurmak, dövmek, dokumak
tutsuk: vasiyet
boyla: rütbe, ünvan, has isim
yab: müdevver
yabrıt-: meydan okumak
yadag: yaya
yadrat-: yere atmak
yag-: yağmak
yagaru: yakına, yakına doğru
yagı: düşman
yagı-: düşman olmak
yagıçı: düşmana giden, düşmana salan
yagıd-: düşman olmak, düşman kesilmek
yagıl-: yığılmak, toplanmak
yagısız: düşmansız
yagız: yağız
yaglıg: yağlı
yagrı-: zehirlenmek
yaguk: yakın
yagut-: yaklaşdırmak
yalabaç: sefir, elçi, reis, şef
yalıŋ: yalın, çıplak
yalbar-: yalvarmak
yalga-: yalamak
yalım: yalın, sert
yalıŋus: yalınız
yalma: at kaftanı, at örtüsü
yan: yan, yan taraf
yan-: geri dönmek
yandar-: yandırmak, yanmak
yandur-: geri döndürmek
yaŋı: gün
yaŋıl-: yanılmak
yaŋra-: çınlamak, ses çıkarmak
yak: yakın
yaka: yaka, hudud
az: az
az-: azmak, yoldan çıkmak
azu: yahud, şayed
azuk: azık, katık
beŋiz: beniz
bentez: bina
biligsiz: bilgisiz
bir otuz: yirmi bir
biz: biz
boz: boz rengi
boz-: bozmak
ezinçü: mütebaki, arkaya kalan
köz: göz
közed-: gözetmek, korumak
közle-: gözlemek, gözetlemek
kör-: görmek, itaat etmek, tabi olmak
körgü: itaat
kut: kut, saadet, bahtiyarlık
terkiŋ: bir ünvan, rütbe, kendisine itaat edilen amir
yol: yol, seyahat, saadet, tali
yükündür-: baş iğdirmek, itaat ettirmek, boyun iğdirmek
kab-: kapmak, birleşmak
kabak-: kızlık, bekaret
kabış-: kavuşmak, buluşmak
kodı tabışgan: ada tavşanı
Kabay: bir boy adı
Tabar: yer adı
Tabgaç: Türklerin Çinlilere verdiği ad
Tatabı: Üç kısma ayrılmış olan Kıtanyların sonraları Hi denen Ku-mo-hi kabilesi
Yabaş: ırmak adı
Yabaş Tutuk: özel ad
bile: ile, beraber
birle: ile, birlikte, beraber
terkle-: acele etmek, koşmak
Berçeker: Acemler
turug: mesken, durulacak yer
tügünük: duman deliği, baca
kaç-: kaçmak
kaçın-: kaçınmak
kaçış-: kaçışmak
Bilge Taçam: adına Ongin yazıtı dikilen Türk kağanı
Buzaç Tutuk: özel ad
Ugraç: özel ad
tez-: kaçmak
tok: tok, aç değil
yürüŋ: beyak, ak, açık renk
kadın: kayın, hısım
kadır: sarp, güçlü, şiddetli, müthiş
kadırık: bükülen, çevrilen
kulad-: kul, esir olmak
yokad-: yok olmak
Ezgenti Kadaz: yer adı
Kadırkan: Kingan dağları
Tadık Çor: özel ad
at: ad, isim
Işbara Bilge Küli Çor: adına İhe-Hüşotü yazıtı dikilen Tarduş kağanı, tegre: çevre, etraf
tertrü: uygunsuz, muvafık olmayan
tėgin: prens, hükümdar aile etrafının ünvanı
tirkiş: kervan, kafile
toruk: duru, saf
Ozmış Tigin: 744 yılında Basmıllar tarafından öldürülen prens
Agu: yer adı
Agulıg: yer adı
karag: göz bebeği
kışlag: kışlak
yaru-: ağarmak, ışımak, aydınlanmak
öz: iki dağ arasındaki dere ve çevresi
kargu: dağ tepelerinde üzerinde ateş yakılarak düşmanın geldiği haber verilen ateş kulesi
katıgdı: sağlamca, sıkıca, iyice
kodı: alt, aşağı
toŋta-: aşağı iğmek
bitig: yazı, tahrirat, kitap, yazıt
büke: kahraman, cesur
ėlle-: el sahibi eylemek, yurd sahibi kılmak
ėllig: el'li, el sahibi, yurd sahibi
örüŋmeg: ışık, beyazlık, nur ilahi
özlük: şahsi, zati, kendine ait
kara: kara, siyah, avam
kullıg: kullu, kul sahibi
kutlug: kutlu, mesud, bahtiyar
uzuntonlug: rahib, manastıra çekilen târik-i dünya, papas
yarak: silah
yaraklıg: silahlı
ak: ak, beyaz
Ak Termel: yer veya ırmak adı
ayak: kadeh
bulgak: karışık, alt üst olmuş
konuşmak: konuşmak
kulkak: kulak
kurugsak: kursak
tırŋak: tırnak
tograk: kavak
yımşak: yumuşak, mülayim
Alanı İçreki: özel ad
Alp: özel ad
Alp Salçı: özel ad
Alp Uruŋu: özel ad
Alp Uruŋu Tutuk: özel ad
Altı Çub: kavim adı
Altı Oguz: Oğuzların altı boyu
Altuga: özel ad
Altu Şan: yer adı
Altun Kır: yer adı
Altun Tay Saŋun: özel ad
Altun Tamgan Tarkan: özel ad
Altun Yış: Çince kaynaklarda Kin-şan diye geçen Altay Dağları
Amga Kurgan: yer adı
kamaş-: sarsılmak, burkulmak
kamaşıg: asi, kıyam eden, harekete getirilen
kamıl-: yuvarlanmak, devrilmek
kamıç: kepçe, kaşık
kamşa-: kımıldamak, hareket etmek
kamuş: kamış
Bilge Işbara Tamgan Tarkan: özel ad, ünvan, rütbe
Er Kamış: yer adı
Işbara Tamgan Çor: özel ad
Işbara Yamatar: özel ad
Ogramış: kadın adı
Talakamın: yer adı
Tamag Iduk: Karluklarla Göktürklerin savaştığı yer
Taman Tarkan: özel ad
Tamgan: özel ad
Tudun Yamatar: özel ad
Yamatar: özel ad
Yamı: bir Türk hükümdarı
ay: ay, kamer
Anı: ırmak adı
Aŋkas: özel ad
bosanç: elem, keder
Apar: Avar kavmi
Apa Tarkan: özel ad, ünvan, rütbe
Apurım: Apar kavim adıyla yazılan bir kavim adı
Beçe Apa İçreki: özel ad
Inançu Apa Yargan Tarkan: Orhun yazıtlarında adı geçen Türk Beyi
Külüg Apa: özel ad
Kapagan: Çince kaynaklarda Me-çüe diye geçen meşhur Göktürk Kaganı
Kul Apa Uruŋu: özel ad
Öz Apa Tutuk: özel ad
Temir Kapıg: Belh'den Semerkand'a giden yol üstünde Keş kentinin 90 km güneyinde 12-20 m genişliğinde ve 3 km uzunluğunda bir geçit
Teŋlig Apa: özel ad
Tör Apa: özel ad
ėt-: eylemek, yapmak, düzeltmek
it-: yapmak, tanzim etmek, eylemek, kılmak
itit-: yapdırmak
Arkar: ırmak adı
Aruk: kadın adı
işbara: rütbe, ünvan
Asug: özel ad
yasa-: tanzim etmek, yapmak
yası: düz, yassı
yasıç: mızrak
Basmıl: Çince kaynaklarda Pa-si (k) -mi (t) diye geçen Türk kavmi
Er Aŋkas Töşek: özel ad
Ogul Asug: özel ad
süle-: asker sevk etmek, sefer etmek
tözlüg: asıllı, esaslı, köklü, unsurlu
öt: nasihat, öğüt
ötle-: nasihat etmek
kaş: kaş
yaş: yaş
yaşa-: yaşamak
yaşıl: yeşil
kanat: kanat
kanatlıg: kanatlı
kat: kat
kat-: katmak, ilave etmek
kata: defa, kerre
katı: katı, sert, kavi
katıg: katı, sert
katıglan-: uğraşmak, cehdetmek, çalışmak
katıl-: katılmak, iltihak etmek
katlan-: katlanmak
katun: kraliçe, hatun
kısalat-: kısaltmak, kısmak
kobrat-: toplanmak, toplatmak
ėl: el, eyalet, vilayet, kavim
kün: kavim, halk
kuşla-: kuşlamak, kuş avlamak
suŋur: sungur denilen av kuşu
süŋüş: savaş, muharebe, harp
tug: tuğ, bayrak, davul
tüŋür: davul, şaman davulu
ay-: söylemek, takdim etmek
ayıt-: sormak, söylemek
kaya: kaya
kutay: ipek kumaş
turunyaya: turna kuşu
yay-: yaymak, perişan etmek
yay: yaz
yayla-: yaylaya çıkmak, yazlığa çıkmak, yazlamak
yaylag: yayla, yazın oturulan yer
yırdandayın: şimalden, yukarıdan
Bay Balık: kent adı
Bayırku: Çince kaynaklarda Pa-ye-ku diye geçen Türk kavmi
Bayna Saŋun: özel ad
Az: Kögmen dağlarında oturan bir kavim
Azganaz: özel ad
Azman: at adı
kazgan-: toplamak, birikdirmek, kazanmak
kazganç: kazanç
yaz: ilkbahar, yaz
yaz-: günah işlemek, kabahat işlemek
yazı: ova
yazıg: serbest, hür
yazıŋ-: kabahat işlemek, günah işlemek, yanılmak
yazukla-: günah eylemek, kabahat işlemek, hata etmek
yazuklıg: günâhkar, kabahatli
biti-: yazmak
bitigli: yazılı
bitit-: yazdırmak
kurdan: geriden, garbdan, garblı
kurıya: geriye, geride, garbda
belgü: alâmet, nişan
belgülüg: alâmetli, nişanlı
ben: ben
beŋgü: ebedi âbide, anıt
bėrü: beri
İstemi: Batı Göktürk devletini kuran Yabgu
Tay Bilge Tutuk: yazıtta Yabgu tayin edilen Türk beyi
bıç-: biçmek, kesmek, yırtmak
bıŋa: bin, 1000
kobı: boş, tükenmiş
kod-: koymak, bırakmak, terketmek
yargan: zâbıta âmiri, polis müdürü
bi: kısrak
biç-: biçmek, koparmak, kesmek
biçi: kadın, kraliçe
biçin: maymun
bil-: bilmek
bilig: bilgi, malumat
bilin-: bilinmek
biŋ: bin
bin-: binmek
binçü: (?)
bintür-: bindirmek
bir: bir
birik-: birikmek, toplanmak
bir kırk: otuz bir
bisük: beşik
bitkeçi: kayıd memuru, kâtip
Bilge: özel ad
Bilge Çikşin: özel ad
yükmek: bkŋz; kökmek
Tezik: Türklerin Arablara ve müslümanlara verdiği ad
bolun: esir, tutsak
Bolçu: ırmak veya yer adı
Boyla Baga Tarkan: özel ad, ünvan, rütbe
Boyla Kutlug Yargan: özel ad, ünvan, rütbe
böri: kurt
Bölen: özel ad
Böri: özel ad
Öre Bört Tutuk: özel ad
koŋuz: böcek
yar-: yarmak, bölmek
kubran-: toplanmak, birleşmek
subsız: susuz
bu: bu
bugra: erkek deve
bugralık: erkek develik
bul-: bulmak
bulga-: karışdırmak
bulıt: bulut
bulıtlıg: bulutlu
buŋ: mihnet, keder, elem
bunça: bunca, bu kadar
burua: guru
buyruk: buyruk, âmir, komutan
bük-: doymak
bünteg: serseri
Bükegük: yer adı, ormanlık
Öz Bilge Bünyin: özel ad
Karluk: üç büyük boya ayrılan ve Altaylarda oturan Türk kavmi
karı: yaşlı, ihtiyar, kocamış
karı-: ihtiyarlamak, kocamak
kol-: yalvarmak, reca etmek
komursga: karınca
kurt: kurt, solucan
teyen: sincap
ėŋilk: en ilk, en önce
közünük: pencere
yartımlık: yardımcı, muavin
yat: yabancı
yugçı: aylayıcı, ağlayan
yėgirminç: yirminci
yėtinç: yedinci
Togla: Tola ırmağı civarında bir kent
Togu Balık: Tola ırmağı civarında bir kent
Uygur: Çince kaynaklarda Wei-ho diye geçen Moŋgolistan'ın kuzeyinde oturmuş Türk kavmi, Göktürklere tabi olmuşlar sonra Göktürkleri yıkarak Selenge ve Tola ırmağı civarına yerleşmişler, 630'da Çin'e tabi olmuşlardır
kılın-: yapılmak, vucuda gelmek
konyçı: koyuncu
tokuzınç: dokuzuncu
yaratur-: yapdırmak, vücude getirtmek
Tatar: dokuzuncu asrın başlarında adları Çince kaynaklarda Ta-ta diye geçen Moŋgollardan bir kısım
Umay: çocukları koruyan tanrıça
törtünç: dördüncü
yelme: öncü, keşif kolu
kança: nereye
Tuçayan: özel ad
Uz Bilge Çaŋsı Uz: özel ad
küzeŋü: çan, zil, ayna
titig: çamur
kılıçla-: kılıçlamak, kılıç çalmak
yiçe: tekrar, daha
Kü Çekül Tutuk: özel ad
tıtın-: çekilmek, dayanmak
suçulun-: kopmak, çekilip çıkmak, sıyrılmak
tolgat-: dolatmak, muazzeb etmek, eziyet çekdirmek
yinçge: ince
Ėl Inançı: Ėl Ügesi gibi bir ünvan
Işbara Çıkan: özel ad, ünvan, rütbe
Sarıgçır: özel ad
yokla-: çıkmak, yükselmek
ėçin-: kerem kılmak, doyumluk vermek
süçig: tatlı
toyukçin: nalbant
yėrçi: rehber, kılavuz
Bagatur Çigşi: özel ad
Inançu Külüg Çigşi: özel ad
Keçin: yer adı
Kül Çigşi: özel ad
Kutlug Çigşi: özel ad
Udur Çigşi: özel ad
Uruŋu Tudun Çigşi: özel ad
küçlüg: güçlü
Ėlç Çor Küç Bars: özel ad
Inançu Çor: özel ad, ünvan, rütbe
Külüg Çor: özel ad
Oglan Çor: özel ad
Kar Çor: özel ad
Kara Çor: özel ad
Unagan Çor: özel ad
Yigen Çor: özel ad
kalın: çok, fazla
kubar: çoğalmak, toplanmak
Koçu: Doğu Türkistan'daki Hoço kenti
sökür-: diz çökdürmek
konçuy: prenses
kunçuy: prenses
Beg Çur: özel ad
Buçur: özel ad
İte-çuk: özel ad
Inançu: özel ad, rütbe, ünvan
Inançu Alp: özel ad
Inançu Bilge: özel ad
Sugçu: kent adı
sıŋar: yarı, buçuk
Edçü Saŋun Tire: özel ad
İn Öz İnençü: özel ad
Süçür: özel ad
Yėnçü Ügüz: Zerefşan ırmağının adı
yıdıt-: çürümek
yorç: kadının küçük erkek kardeşi
İnel: Kapagan Kaganın küçük oğlu
Kül Tigin: Ėlteriş Kaganın oğlu, Bilge Kaganın küçük kardeşi
kandan: nereden
Sugdak: Soğd kavmi
Udar Seŋün: özel ad
Usın Bundatu: özel ad
toş: dağ üzerinde birikmiş su
tögünlig: dağlı, dağlanmış, damga vurulmuş
kargan-: beddua edilmek, ayıplanmak
yobal-: kapanmak, seddolunmak
yut: soğuğun şiddetinden hayvanların kırılması, salgın
Türk: mukaddes soyumuzun ebedi adı
Erdem Kaŋ Altuga: özel ad
tegür-: değdirmek, vasıl etmek, erişdirmek
telin-: delinmek
ter-: dermek, toplamak
teri: deri
tė-: demek
tügül: değil
kudız: dul kadın
Özüt Ogdı: özel ad
ėlsiret-: elsiz kıldırmak, yurdsuz eyletmek
Bindir: özel ad
Ediz: bir Oğuz boyu
Edizker: Oğuzlardan Ediz boyuna mensub kavim
Kedim Uruŋu: özel ad
özge: diğer, başka
teŋrilig: dindar, din adamı
tėle-: dilemek
tik-: dikmek
tiŋle-: dinlemek
tirig: diri
tiril-: dirilmek
titir: dişi deve
tiz: diz
tizlig: dizli, dizi olan
tıl: dil, harpde haber almak için tutulan adam
tıŋla-: dinlemek
tod-: doymak
tog-: doğmak, çıkmak, neşet etmek
togan: doğan kuşu
togu: doğu
toŋ-: donmak
toŋuz: domuz
tokıt-: dokutmak, yontturmak, vurdurmak
tokuz: dokuz, 9
tokuzon: doksan, 90
torıg: doru, at rengi
tosık: doymuş, tok
tüşnek: dost, arkadaş
tüz: doğru, kusursuz
Tarduş: Doğu Göktürklerin batısında bulunan bir Türk kavmi, Bilge Kagan kagan olmadan önce bu kavmin Şad'ı idi
ötrü: ötürü, dolayı, sonra
kulunla-: tay doğurmak
kurıgaru: geriye doğru, garba
tegzin-: dönmek, dolaşmak, devretmek
tört: dört
tük-: dökmek, dağıtmak, bozmak
yėlü: dört nala gitmek (at)
tört yegirmi: on dört, 14
kudruk: kuyruk
teŋ: takat, kudret
ėlsire-: elsiz kılmak, yurdsuz eylemek
kondur-: kondurmak, yerleştirmek, iskan etmek
kudursug: kuyruk
tudun: rütbe, ünvan
Iduk: nir pınar başı, yer adı
Kül Tudun: özel ad
Tudun: özel ad
Udun: özel ad
tulı: dul
tuman: duman
tur-: durmak, ayağa kalkmak
tuy-: duymak
kalısız: kalmadan, derhal, hemen, durmadan
sü: ordu, asker
sület-: sefer ettirmek, ordu sevk ettirmek
törün: düğün, merasim
türt-: dürtmek
tüş-: düşmek, dinlenmek, konmak
tüşür-: düşürmek
tüzel-: düzelmek
küntüz: gündüz
kuy: ırmakin düzlüğü, ırmak kenarı
sokuş: karşılaşmak, rastlamak, tesadüf etmek, vuruşmak
tüg-: bağlatmak, düğümletmek
Kürebir Uruŋu Saŋun: özel ad
Sebeg Kül İrkiz: özel ad
tün: gece
kışla-: kışlamak, kışı geçirmek
yarın: yarın, erken geç, ergeç, sabah
yeged-: yükseltmek, yüceltmek
közünç: şöhret, şan, şeref
surug: şan, şeref, şöhret
yotuz: zevce, refika, karı
teglük: kör
tokuz yegirmi: on dokuz, 19
yegren: kula rengi, at rengi
yėg: iyi, daha iyi
yėgen: yiğen
yėgirmi: yirmi, 20
kaltı: eğer, şayed, yani
tutug: rehin
Bėş Balık: Çince kaynaklarda Pei-ting diye geçen kent, Tien-Şan'ın kuzeyinde Urumçi kenti
Ulug Ėrkin: Bayırkuların reisi
ėlet-: iletmek
Elekül: özel ad
Ėlbilge: Ėlteriş Kaganın karısı, Bilge Kaganın annesi
Ėlteriş: Çinlilerin Kutlug dediği Doğu Göktürk Devletini tekrar dirilten Türk Kaganı
Ėl Togan Tutuk: özel ad
tükel: tam, tamamıyla
yel: gelmek
yelü: yele
yėme: yene, tekrar
Kem: Yenisey kollarından bir ırmak
Toŋra Semig: özel ad
yarlıg: emir, ferman
eşen-: binmek, sürmek
örten-: yanmak
teŋri: tanrı, sema, gök
Sepinlig: özel ad
Yogra Yarış: tepe adı
ėrinç: iyi yaşayış, nimet içinde ömür sürme
Eren Ulug: özel ad
Erkin: özel ad
Ersegün: yer adı
Ėrtiş: ırmak adı
Keŋeres: yer adı
Tinesi Oglı Yatıgma: özel ad
kü: ses, şöhret, şan
kul: kul, köle, esir
eş-: sürüp gitmek
ėş: eş, arkadaş
küneş: güneş
sözleş-: sözleşmek
Tekeş: özel ad
Töŋkeş: bir dağ adı
külüg: meşhur, şöhretli
et: et
kırk artukı yeti: kırk yedi, 47
tüket-: tüketmek, bitirmek
yėt-: yetmek
yėti: yedi, 7
yėti biŋ: yedi bin
yėti otuz: yirmi yedi
yėti yėgirmi: on yedi
yėti yüz: yedi yüz, 700
yėtmiş: yetmiş, 70
yėtür-: bitirmek, mahvetmek
küz: güz mevsimi
Keyre başı: yer veya ırmak adı
kış-: eylemek, yapmak
örüŋ: beyaz, ak
kıl-: kılmak, eylemek
yarlıka-: buyurmak, emretmek, ferman eylemek
Ezgene: özel ad
tezkin: gezme, dolaşma
Tez: yer adı
Kıtany: 405'de ilk kez adı geçen bugünkü Tunguzların atası olan kavim
Ötüken: Göktürklerin hükümet merkezi
tök-: bağlamak, ittifak akdetmek
yıta: ne fayda, ne çâre, beyhude
yuyka: yufka
uyarlıg: nüfuzlu
kısga: kısa
kurtga: ihtiyar
yırgaru: şimale doğru, yukarıya doğru
yogaru: yukarı
Sugd: Soğd
yügerü: yukarı, semaya
Bilge Köŋül Saŋun: özel ad
Bilge Şaŋun: özel ad
Bilge Tonyukuk: 650'de Çin'de doğan adına yazıt dikilen 716'da ölen Türk devlet adamı
Kül Bilge: 685-712 arasındaki Uygur Kaganı
Oguz Bilge: özel ad
Öz Yigen Alp Turan: özel ad
Tay Üge: özel ad
kangı: prens
kırgıglıg: kırkılan, kırpılan
Kırgız: Yukarı Yenisey'de Kem ve Kemçik havalisinde oturan Türk kavmi, Uygurları yıkmışlardı
örgin: saray, konak
süŋüglig: mızraklı, süngülü
tuglıg: tuğlu
tuyuglug: nallı, tırnaklı
yatıglıg: yatan
Otus Oglan: özel ad
Yaglakar Kan Ata: özel ad, ünvan
Kögmen: Sayan dağları
Yagma: bir Türk boyu
Yagmış Tutuk: özel ad
Yatıgma: özel ad
Begni: özel ad
Otuz Tatar: Bir Moŋgol kabilesi
Seleŋe: Kuzey Moŋgolistan'da Selenge ırmağı
Tokuz Tatar: Moŋgolların bir boyu
itu-: göndermek
köŋül: gönül
körüş-: görüşmek, buluşmak, bir araya gelmek
kötür-: götürmek, yükseltmek
tüs: görünüş, manzara
Karluk Köl: göl adı
Taygan Köl: göl adı
Tokuz Oguz: Göktürklerin kuzeyinde oturan sonraları Uygur adıyla ortaya çıkan Türkler
Türgi Yargun: göl adı
Yula Köl: göl adı
körüklüg: manzara, görünüş
Bumın: Çince kaynaklarda Tu-men diye geçen Göktürk Devletini kuran Kagan
Onok: Batı Göktürkler
tigrat-: ses çıkartarak hışıldatarak yürütmek (at için)
Ögsüz: at adı
yögtür-: yükselmek, çıkmak
kogu: koğu kuşu
kuzgun: kuzgun, karga
toguru: doğru ...istikametinde
toygun: yüksek rütbeli memur
toygut: toygun'un cemi
turgur-: kaldırmak, doğrultmak
yogun: kalın, kaba
yogur-: yoğurmak, çiğnemek
yögürt-: koşdurtmak
yügür-: yürümek, akmak, koşmak, seyretmek
yany-: yaymak, dağıtmak
Orkun: Orhun ırmağı
Üç Karluk: Altay ve Ėrtiş havzasında oturan bir Türk kavmi, Çince kaynaklarda da bunların üçe ayrıldığı yazar
Yaşıl Ügüz: Hoang-ho ırmağının adı
yükün-: iğilmek, ibadet etmek, ihtiram etmek, baş iğmek
Kara Kum: Hangay sıradağlarının güney sırtları
yıg-: yığmak, toplamak
yulı-: yağma etmek
tüzsiz: kusurlu, doğru olmayan
İzgil: Oğuzlardan bir boy
Oguz: Tarihi Doğu Hunlarına kadar çıkan Oğuz kavmi
Sekiz Oguz: sekiz Oğuz boyundan oluşan bir birlik, Sekiz Oğuzlar
Üç Oguz: Üç Oğuzlar
yılkı: hayvan sürüsü, yılkı
kür: müthiş, sarsılmaz
yüzlüg: mevki sahibi, rüesadan olan
yuş: zahmet
yılsıg: muhteşem, parlak
yolıg: mesud, bahtiyar
yöne-: zuhur etmek, çıkmak
Yolıg Tigin: İki Orhun yazıtını yazan prens
Tensi: Çin hükümdarı
kılıç: kılıç
Otka Könmiş Kılıç: özel ad
kıd-: ilerletmek
turuk: zayıf
konylıg: koyunlu
kokulık: kokuluk, kokulu
sık-: sıkmak, sıkıştırmak
yarık: zırh
yıllık: yıllık, senelik
yorık: gidiş, seyr
Balıklıg: ırmak adı
Kurıkan: Çince kaynaklarda Ku-li-kan diye geçen sonrasında Uygur kabilesi olan Türk kavmi
Üç Kurıkan: Baykal havalisinde oturan bir Türk kavmi olup sonraları Uygurlara tabi olmuşlardır
kızıl: kızıl, kırmızı
yarıl-: yarılmak
yıl: yıl, sene
yılan: yılan
tig: sarı, sarımtrak
tıg: at rengi, sarımtırak
karın: karın
korkınç: korkma
sınuk: kırık
kırk: kırk, 40
tokuz kırk: otuz dokuz, 39
yırıya: yukarda, şimalde
kıs-: kısmak
kış: kış
yış: üstü ormanla kaplı dağ, orman
