a: ünlem karşılığı olarak kullanılır
ab: av
abam: bkŋz; apam, bkŋz; abaŋ, eğer, şayet
abam birük: eğer, şayet, bir defa
abamu: daimi, ebedi, ölmez, mengü, bengü, sonsuz
Abamu: özel erkek adı
abamuluğ: daimi olan, ebedi, mengü, bengü, ölmez
abaŋ: bkŋz; abam
Abıç: özel erkek adı
Abık: erkek adı
abın: bkŋz; evin
abınç: rahatlık, sevinç, refah, avunma
abınçu: avunma, teselli, sevinç, cariye
abınık: dölek, sakin, mutlu, huzur
abıt-: teskin etmek, avutmak
abiçi: (Sanskritçe Abhijit), bir yıldız adı
abişik: (Sanskritçe abhiseka), (Toharca abhisek), takdis etmek, kutlamak
abita: (Sanskritçe Amitābha), burhan, tanık, delil
ab-: fışkırarak çıkmak, akmak, fışlamak
abra: arpa
abuçka: koca, ihtiyar, kocamış kimse
aç: aç, açlık, açmak, yaymak, çok geniş bir alana duyurmak, acıkmak
açağ: bkŋz; açığ, acı
açağram: yılan kelimesi ile beraber 'Boa constrictor' yılanının adıdır, öteki söylenişi Ançakram
açani: (Sanskritçe ājāneya), soy, soylu, ırk, soylu kök, imtiyazlı
açari: (Sanskritçe āçārya), hoca, öğretmen
açarya: hoca, öğretmen, üstad
açığ: öfke, kızma, şiddet, acı, ızdırap, ekşi, acımtırak, hediye, armağan
açığlı: açık, açılmış olan
açıl-: açılmak, açılmış olmak
açı-: acımak
acın-: acınmak, temizlenmek, arılanmak, arınmak, açıklamak, itiraf etmek, açığa vurmak, özenmek, özen göstermek, itina etmek, ihtimam göstermek
Açık: özel ad
açıt-: acıtmak, ağrıtmak, gönül kırmak, acı duyurmak
açita: (Sanskritçe), semavi mızıkacı, görsel çalgıcı
açlık: açlık
aç-: acıkmak, acıkmış olmak, açmak, çözmek, yaymak
açkınça: açınca
açsık: acıksama, açlık, açıkma
açsız: tok, tokluk
açuk: açık
ad: ün, şöhret, çav, san
baars: bkŋz; bars
baba: baba, peder
babakir: bkŋz; bayagir
babagir: bkŋz; bavagir
baça: günah
Baça: kişi adı
baçağ: oruç
baçağ otur-: oruç tutmak
baça-: oruç tutmak
Baçan: erkek adı, kişi adı
baçak: bkŋz; baçağ
Baçara: kişi adı
bad: bat
bad-: bkŋz; batmak, bağlamak, bendetmek, ekin ekmek
badman: bkŋz; batman
badruk: bayrak
Badur: erkek adı, kişi adı
badur: bkŋz; badır, bkŋz; batır [Hukuk vesik.], Mayi ölçüsü
badyan: ilaç için kullanılan bir bitkidir'Illicium anisatum'
bağ: bağ, bent, köstek, boğça, kabile, boy, halk topluluğunun bir bölümü, (Farsça bağ, bahçe)
bağa: kara kurbağa, odlu bağa
Bağa: bir rütbedir
bağarsuk: bkŋz; bağırsak, bkŋz; bağırsuk
bağ borluk: üzüm bağı
bağça: bohça, bağ, çıkın, paket
balak: bkŋz; balık, balık
balığ: bkŋz; balık
balığça: balık gibi
bağçı: bahçıvan, bağçı
bağır: karaciğer, göğüs, karın, bir ilaçtır, sevgili, akraba
bağırsak: bağırsak, bkŋz; bağursuk, merhamet
bağırsuk: bkŋz; bağırsak
bağış: kalın urgan, halat
bağla-: bağlamak, raptetmek
bağlığ: bağlı, tutuklu, bohça, paket
bağrın: bağır ile
bahşi: muallim, öğretmen, ustad, hekim, doktor, tabip, bkŋz; bahşı
bak: bkŋz; bağ
bakanak: nal
bakar: bkŋz; bakır, mangır, para
bakçan: tahayyül, tefekkür, mütalaa
bakı: bakır, tartı ölçüsü, sikke, para, mangır
bulıtculayu: buluta benzer
çamhui (Çince tsch'an-huei): nadim ve pişman olmak
kenckiye: yavrucuk
küin (Çince küän): kitap tomarı
Mha cinadiş: büyük Çin memleketi
temirci: demirci
usdacı: kurtarıcı, halaskar
yağıcı: kinci, kindar
yarlıkançucı: merhametli, şevket ve şefkatli kimse
Yekencük: kişi adı
Adak tutuk: coğrafiya adı, yer adı
ağan: ceza, cezaya çarpma, hüküm giyme
akı: cömert
akış-: caymak, sözüde durmamamak
ala: cüzzam, ela rengi
bıçtaçı: cellat
boğağulukçı: cellat, katil, boğazlıyan
iriz: cilasun, cesur, yiğit
kiket: cem, , yekün, toplam
kivan j-mnu: cumartesi
ködün yınak: cenup, güney
kün ortu: cenuba doğru, öğle
kündin: cenup, güney, güzel
küŋzed-: cariye olmak, karavaş olmak
livaŋ: Caryophyllus oromaticus
maharaurab: cehennemin adı
midik: cahil, inancı bozuk, sapık, yabani, bir şeyin acemisi
nağıd j-mnu: cuma günü
ölüg: ceset, ölü
özlüg: canlı, özlü
özükin: canını, özünü
pratapan: cehennemin adıdır
kakız: cesur, kahraman
katığlan-: ceht etmek, gayret göstermek, dürişmek, uğraşmak, bkŋz; katağlanmak
kıın: ceza, eziyet, zahmet
kıınçı: ceza veren, ceza kesen
çadar: bkŋz; çadır, kül
çadır: kül, bkŋz; çadar
çadik: (Sanskritçe sātaka), (Toharca yātak), (Moğolca tsadık), Sakyamuni'nin ilk doğumu ve doğum tarihi
çadiklig: bkŋz; çadik
çadir: amonyak, nişadır ruhu
çağ: çağ, zaman
çağay: bir bitki adı (olsa gerek?)
çağ-: çakmak, vurmak
çağşaput: bkŋz; çhşapt
Çağrı: rütbe, ünvan
çağur-: iftira atmak, leke sürmek, çamur atmak
çaidan: tapınak, mabet, ibadetgah
çaidir: bkŋz; çaitir
Çaisu: kişi adı
çaitir: (Sanskritçe citrā), bir yıldızın adı
çak: bkŋz; çağ, zaman, tam
çakı: ısırgan otu (bitki)
çakır: (Sanskritçe cakra), tekerlek, çarh
Çakırça: kişi adı
Çakmak: kişi adı
çakşaput: bir ayın adıdır, Uluğ bey takviminde 12.aydır
Çakkoğlı: kişi adı
Çakudu: kişi adı
çaldr: (Sanskritçe Jaladhara), deniz
çal-: vurmak, eğilmek
çalsık-: vurulmuş olmak
çaltur-: aratmak
çam: dava, itiraz (çarım'la), çanak, çömlek
Çambudivip: (Sanskritçe sambudvipa), kainat
çamlağuçı: dava eden, dava açan, davalı, iddia eden
çamla-: dava etmek, çekişmek, itiraz etmek (mahkeme)
çamsız: davasız, itirazsız
çan: bkŋz; çın, çanak
çanak: çanak, kap, ölçü kabı
çaŋ: çan
Çaŋır Taişi: kişi adı
çaŋşı: bir rütbedir
çantal: (Sanskritçe candāla), cellat
Çao: bir sikke türüdür
çarım: dava, iddia, itiraz
Çarır: kişi adı
dana: nar
Danavadi: şehir adı, yer adı
daniş: (Sanskritçe dhanistha), bir yıldız adı
Dantipali: kişi adı
darm: (Sanskritçe dharma), akide
darni: (Sanskritçe dhārani), büyü, sihir
dartiraştri: (Sanskritçe dhrtarāstra), batı dünyasının muhafızı
daruğa: memnuniyet adı
depter: defter
ddintar: bkŋz; dindar
dıdım: (Soğdca didim), taş
dıdımlığ: taçlı
dın: (Soğdca den), din, mezhep
dındar: dindar, din ayinlerini idare eden, yürüten
dıntar: bkŋz; dindar
dian: bkŋz; diyan, altı veya 10 erdemden biri
didm: dıdım
din: bkŋz; dın
dindar: bkŋz; dındar
Dipankari: Budda'nın adı
divini: İlahe, tanrı
divdar: çama benzer bir ağaç
diyan: (Sanskritçe dhyāna), istiğrak, (Moğolca Diyan)
dosa: vücudun temel unsuru, iksiri
drm: (Sanskritçe dharma), din, akibe
drma-utarı: Bodisatva'lardan birinin adıdır
drzul: yabaya benzer üç dişli bir alet
duşkrçar: (Sanskritçe duşkaracaryā), ızdırap
Duşta: kişi adı
dutagun: günahlardan arınmış ve kurtulmuş kimse
dyan: bkŋz; d (i) yan, teemmül
dyanlağ: istiğraklı, istiğraka ait olan
dile-: dilemek, istemek
dilen-: dilenmek, arzu edilmek
eb: ev, bkŋz; ev
ebçi: eş, karı, kadın
ebin: tane, tohum
eçe: ağabey, büyük kardeş
eçi: bkŋz; eçe, ağabey
eçkü: keçi
eçü: eslaf
ed: madde, mülk, servet
eded-: ulğadmak'la beraber kullanılışına göre maddeleşmek, büyümek manasındadır
eder-: bkŋz; idermek
edgü: iyi, üstünlük
edgüli: iyi, üstün, iyilik
edgülüğ: münasip, uygun, iyi, üstün, iyilik
edgülük: iyilik, bkŋz; edgülüg
edgüti: iyice
Edgü Toğrıl: kişi adı
edik-: başarmak, meydana getirilmek, elde etmek
edirem: bkŋz; erdem
ediş: bkŋz; egdiş, idiş
Ediz: bkŋz; idiz
edlig: zengin, varlıklı, servet sahibi
edligsiz: değersiz, kıymetsiz
edrem: bkŋz; erdem, erdem
edremlig: erdemli, faziletli
edsiz: lüzumsuz, istifadesiz
edüz: bkŋz; ediz, idiz
eger-: bkŋz; eŋir-
Egdeçin: kişi adı
egdilet-: terbiye etmek, büyütmek
egdiş: bkŋz; idiş
egdü: eğri bıçak
egid-: terbiye etmek, büyütmek, yükseltmek
egim: bkŋz; eŋim
egin: bkŋz; eŋin, omuz
egirgü: eğiren, çeviren
egir-: eğirmek, çevirmek, kuşatmak
egirt-: iğritmek
eg-: iğmek
egri: iğri
egrik: su anaforu, burgaç, çevrengeç, çölek, girdap
egril-: iğrilmek
ferişti: melek
fişailığ: (Sanskritçe Visaya), anlayışlı, duygulu, akıllı, uslu
farinibran: bkŋz; frnibran
frnibran: (Sanskritçe Parinirvāna), kişi adı
futsi: bilge, bilgin, alim, ustat
Futsi: kişi adı, üstad, (Çince fu-tze)
huastuanift: huastuanift
köfenç: bkŋz; kövenç, gurur, kibir
köfençlig: kibirli, mağrur
kıfırka-: bkŋz; kıvırkamak
kıfrak: bkŋz; kıvrak
sef-: bkŋz; sevmek
tafran-: bkŋz; tabranmak
tilfe: tilbe, abdal, aşık, deli
ufşak: ufak
yafşur-: yapıştırmak, yanaşmak, yapışmak, bkŋz; yapşurmak
Yausif: Yusuf, bkŋz; Yausip
adrukluğ: fevkalade, parlak, üstün
ağrığlan-: fenalaşmak, ağrıları artmak
borsu: fasulye
çığay: fakir, yoksul
ertiŋü: fazlasıyla, fevkalade, son derece
ıdı: fevkalede, kesin olarak, tümü ile, toptan
ırkla-: falcıdan sormak, çeke çeke dışarı çıkarmak
irinç: felaket, sefillik, bahtsızlık
küzgü: fare, bkŋz; küskü
meŋüsüz: fani, ölümlü, ebedi olmayan
muŋadınçığ: fevkalede, olağanüstü, hayrete şayen, iztırap verici
özeki: fevkalade, üstün, olağanüstü
pitpidi: filfil, biber
pükür-: fışkırtmak, sıçratmak
kam-: fırlatmak
kavağu: fitil, kaytan, kav
koluŋa: filiz
sakınç: fikir, düşünce, niyet, tasavvur, istiğrak
sımtağsız: faal, enerjik, çalışkan
siŋile-: feryat etmek
göksil-: parçalanmak, yarılmak
Gaŋ: (Sanskritçe gaŋā), Ganj nehrinin adıdır, bkŋz; Kaŋ
Gantahast: (Sanskritçe Gandhahastī), kişi adı
got: (Sanskritçe godhā), kertenkele
Griçantri: bkŋz; Hariçantri
griçantri: haricandra [kral adı], bkŋz; Horiçantri
algil: al, alıver
an bitig: Alınyazısı, mukadderat, kader kitabı, sonuç
aŋgarak: bkŋz; angarak
aŋığ edgü: çok iyi
anoşagan: ölümsüzler, ölmezler, ebedi yaşayanlar
ayakka tegimlik: itibarlı, şanlı, hürmetli
ayığ bilge: kötü fikir, hile, fena adam
balık begi: şehir beyi, vali
bavagir: hayat, kainat
bayagir: bkŋz; bavagir
bklıg: bkŋz; beklig
beg: bey, efendi, beg er 'şehzade, prens', erkek, eş, koca, berk
Beg Arslan: erkek adı, kişi adı
Beg Bars: erkek adı, kişi adı
Beg Buka: erkek adı, kişi adı
beged-: beylik etmek, hükümetmek
beget-: bkŋz; begedmek
begimsin-: beylik taslamak, bey kılığına girmek, kendisini bey sanmak
beglig: beyli, şahane, bey soyundan
begni: bkŋz; bekini, bira
begrek: bey, sehzade
Beg Taş: erkek adı, kişi adı
Beg Temir: erkek adı, kişi adı
Beg Turmış: erkek adı, kişi adı
Begü Tutuk: erkek adı, kişi adı
bekiz belgülük: açık, sarih, belli
belgü: alamet, sembol, işaret, belge, fal
belgülüğ: belirli, görünen, alametli, tanınan
belgür-: belirtmek, belli olmak, görünmek
belgürme: belirtme, zuhur, ortaya çıkma, görünme
belgürt-: belirtmek, belli ettirmek
belgüsüz: belirsiz, alametsiz
beliŋlegü: korku
beliŋteg: korkma, donup kalma
ğatığ: katı, sert, sağlam
ğılınç: bkŋz; kılınç
ğıl-: bkŋz; kılmak
ğın: bun, sıkıntı, dert, ızdırap
ğırğıla-: kırlaşmak, alacalanmak
ğız: kız, genç
ğızğat: çeki, mihnet, eziyyet
ğirza: bkŋz; Kirza
ğok: bkŋz; kok, kül
ğonağ: konak
ğorğınçsız: korkunç olmayan
ğor-: kurmak [yay]
ğozmurta: bkŋz; hozmurta
ğoşti: öğretmen, muallim
ğrostağ: bkŋz; krostak
ğuan: suç, yazık, günah, kabahat
Ğulsabadi: kişi adı 'Kulisavati'
ğunçui: bkŋz; kunçui
ğuru: (Sanskritçe guru), muallim, öğretmen
ğuvrağ: bkŋz; kuvrağ
adaklığ: ayaklı
adalığ: tehlikeli, korkulu
Adam Toğrıl: erkek adı
addınçığ: bkŋz; adınçığ
addlığ: bkŋz; atlığ
adığ: ayı
haç: kaç, ne kadar, birçok
haçan: bkŋz; kaçan
haçığ: bkŋz; kaçığ
hadaş: bkŋz; kadaş, arkadaş, akraba
haimavadi: şeytan adıdır
halığ: hava, atmosfer
halın: kalın
halıt-: kaldırmak
haltı: kaldı ki, ne zaman ki, vaktaki, ......ça
han: han, kral, hükümdar, Kan
haŋsız: babasız
hansasvari: (Sanskritçe hamsasvara), özel ad
hantur-: tatmin etmek, kandırmak, inandırmak
hanyu: bkŋz; kayu
hara huş: kartal
harğa: karga
Hariçantri: Haricandra, kişi adı
harı: koca, ihtiyar
harı-: kocamak, ihtiyarlamak
harın: karın
hasğan-: bkŋz; kazğanmak
hast: (Sanskritçe Hasta), yıldız adı
hat: kat, tabaka, kalınlık
hata: defa
hatağlan-: gayret ve cehd etmek, dürüşmek, çalışmak
Hatai: Çin
hatal-: birleşmek, karışmak
hatığ: bkŋz; katığ
hatığrak: bkŋz; katığrak, sağlam, sapasağlam
hatla-: bkŋz; hatalmak
hatun: bkŋz; katun, hatun, kraliçe
havsadıl-: bkŋz; kavşadılmak, birleştirilmek
havsur-: bkŋz; kavşurmak, kavuşturmak, birine bağlamak
hayu: her kimse
hayusıŋa: herbirine
hayuta: herhangi bir yerde
hazğanç: bkŋz; kazğanç, kazanç, servet, hazine
hıl: kıl
hılınç: iş, fiil, hareket, amel
hıl-: bkŋz; kılmak, kılmak, yapmak
hınmak: sabit, sağlam, muhkem
hıska: bkŋz; kıska, kıssa
ı: ağaç, ekin, bitki, nebat, orman
ı ığaç: ağaç
ı tarığ: nebat, ekin, bitki
ıçanğu: çekinme, dikkate alma
ıçan-: çekinmek, kaçınmak, sakınmak, dikkat etmek
ıçın: meşale
ıçğın-: dağılmak, kaybolmak, ufalmak
ıçğun-: bkŋz; ıçğınmak
ıçğunğuçı: kaybeden
ıçkın-: bkŋz; ıçğınmak
ıçlağu: elbise astarı
ıdala-: son vermek, vaz geçmek, el çekmek, bırakmak, terketmek
ıdduk: bkŋz; ıduk
ıdıl-: gönderilmek
ıdım: zaruret, ihtiyaç, tehlike
ıdı-: zenginlenmek, varlıklanmak
ıdıt-: kokutmak
ıd-: göndermek, neşretmek, yaymak, kaçırmak
ıduk: gönderilmiş, kutlu, mukaddes, aziz, mübarek
ıdık kut: rütbe, şahzade adı
ığaç: ağaç
ığaççı: döşemeci, möbleci
ığaççı beg: bir memnuniyet adı
ığla-: ağlamak
ığlaş-: ağlaşmak
ığ-: durgunlaşmak, tıkanmak, ağır ağır akmak (mayi)
ı-: göndermek
ımğa: dağ keçisi
ımrak: bkŋz; amrak
ınağ: sığınak, güven, ümit
ınağsız: melcesiz, sığınaksız
ınan-: inanmak
ınak: dost, arkadaş
ınaru: ileri, -den başka, -den itibaren, buraya
ınaru barı: ileri geri
ınça: böyle, böylece, bkŋz; inçe
ınçak: kaygulu, gamlı
ınçıkla-: hıçkırarak ağlamak, inlemek, hıçkırmak, feryat etmek
ınçıp: böylece
ınğaru: bkŋz; ınaru
ıkur-: tıkanmak, tıkanıklık hissetmek
Inal: memnuniyet ve rütbe ünvanı ve adı, kişi adı
Inal Bars: kişi adı
Inal Buyat: kişi adı
Inal Çuk: kişi adı
Inal Çur: kişi adı
Inal Kuç: kişi adı
Inanç: kişi adı, vezir, vekil, inak, mutemet, nazır, bir rütbedir
inanç buyruk: mutemet, inak
Inak kulı: kişi adı
Indu: kişi adı
Işbara: yüksek bir rütbe
ie: bkŋz; idi, bey, sahip
iç: iç, derun, bir şeyin içi
içegü: iç, bağır, derun
içgek: bkŋz; içkek
içger-: bir şeyin içinde olmak
içgerü: enderun, saray içi, içeri, bkŋz; içkerü
içgerülüğ: saraya mahsus, hükümdara mahsus
içgü: içki
içi: ağabey
içiç: bkŋz; işiç, bkŋz;, isiç
içiglik: içki, içecek, meşrubat
içik-: girmek, dahil olmak (içeriye)
içim: sıvı halindeki yemek
içkek: şeytan, kötü ruh, vampir
içker-: tabi olmak, içeri alınmak, götürülmek
içkermiş ınal: kişi adı, erkek adı
içkerü: içeri
içkü: içki
içlig: gebe, yüklü
iç-: içmek
içre: içre, içerisinde, içeride
içreki: saray mensupları ve harem halkı, ünvan, rütbe
içtin: içten, iç
içtirti: içeriye doğru, içe yönelmiş
içür-: içirmek
id: sayı, hesap, adet
idege: kişi adı
ider: at eğeri
ider-: aramak, takip etmek, arkasını bırakmamak
idi: sahip, büsbütün, bundan dolayı, tam, herhangi, kesin olarak, hiç, bkŋz; ıdı
idig: süs, bezek, ziynet
ajun: dünya
ajunluğ: dünyevi, dünya ile ilgili
arjavrt: Lacivert, (Sanskritçe rajāvarta)
hunjui: bkŋz; kunçui
İrji: kişi adı
küji: yakılınca koku veren nesne, günlük, öd ağacı, misk
mojag: başpapas, başpiskopos
oŋjın: şeytan
parivrajaka: (Sanskritçe) serseri derviş
sajun: halk, cemaat, topluluk
taj: taç
tijit: (Sanskritçe desita), tövbe, bağış, kusur açıklama
tujit: (Çince) kasap, bkŋz; tüzi
Tujit: yer adı, bkŋz; Tuşit, (Sanskritçe tusita)
ujak: hece, harf, bkŋz; usik
üjek: bkŋz; ujak
üjik: bkŋz; ujak
vajir: bkŋz; vaçır
vajra: bkŋz; vçir, bkŋz; vaçir
vjır: bkŋz; vçır
vjırlığ: şimşekli
arçun: " (Sanskritçe arjuna) ""terminalia Arjuna"" adlı bir ilaç adıdır"
Arzı: bkŋz; İrji, bkŋz; irzi
asun: bkŋz; ajun, bkŋz; aşun
aşun: bkŋz; ajun, dünya, kainat
azun: bkŋz; ajun
azunluğ: bkŋz; ajunluğ
kagda: bkŋz; kegde, kağıt yaprağı
kalp: (Sanskritçe kalpe), devir, çağ
kaŋ-si: bir Çin imparatorunun mührü
kanyakubçi: (Sanskritçe kanyakubya), bir şehir adı
karmaput: (Sanskritçe karmapatha), iş yolu
kartisuvarna: Bengalyada bir yer adı
kavl: (Sanskritçe kāvya), şiir
kavişki: Indra'nın lakabıdır
kşan: (Sanskritçe ksana), an, kısa bir an, lahza
kebek: baş kepeği, kir
kebes: bkŋz; kebez
kebez: pamuk
keç: geç
keçe: bkŋz; kiçe, öte tarafta, geçerek
keçik: geçit
keçür-: geçirmek
ked: bkŋz; kid, çok, fazla, sağlam, kuvvetli, zorlu, şöhret, ün
kedgir-: şahlanmak, şaha kalkmak
kedgü: giyim, giyecek, elbise
kedgür-: giymek
kedil-: giyilmek, giydirilmek
kedi-: olgunlaşmak, yetişmek
kedimlig: giyimli, elbiseli, zırhlı
kedin: bkŋz; kidin
Kedire: kişi adı
kedki: sonraki
kedkir-: bir şeyin üzerine düşmek, sendelemek
ked-: giymek
Ked tas: kişi adı
kedür-: giydirmek, giymek
kegd: kağıt
kegde: kağıt
keged: kağıt
keginç: bkŋz; kiginç
kei-: giymek
kek (g): nefret, kin, düşmanlık
kekelik: keklik
keken: bir tür hastalık
keketrün: diş ağrısına, ses ve göğüs tutukluğuna karşı kullanılan ilaç
keklig: menfur
kekne-: tekdir etmek, azarlamak, tehdir etmek, korkutmak
kekük: guguk kuşu
la: yük hayvalanı
lab: emin, sağlam, muhakkak, (Moğolca lab)
labai: (Çince la-pa), (Moğolca labai)
laçın: şahin kuşu, laçın, doğan
lağzın: domuz
laksma: bir tanrı
lakş: bkŋz; lakşa
lakşa: şehriye
lakşan: (Sanskritçe laksana), güzellik, alameti, nişanesi
lala-: ufalamak, ezmek, toz haline getirmek
lan: bir çeşit göz hastalığı
lınha: lotus çiçeği
likçir: (Çince li-ji), takvim
lim: (Çince lin, lim), dam kirişi
limçin: (Çince tien-tsem), bir yıldız adıdır
lin: (Toharca lem), (Pali lena), halvethane, çilehane
linğua: bkŋz; linhua
lisip: balgam, salya
lisp: bkŋz; lisip
liusun: (Çince lu-ts'un), yıldız adıdır
liv: kurban yemeği
lodur: (Sanskritçe lodhra), Symplocos racemosa
loŋ: (Çince lung), ejder
lotr: bkŋz; lodur
lu: bkŋz; luu
luen: (Çince lun), (Sanskritçe sāstra)
Luçan: bkŋz; Luçanta, (Sanskritçe locanā)
Luçanta: Luçanta
Lukitakitu: bir kralın adıdır
luklan: bkŋz; uklan
lukususi: Çince bir yıldızın adıdır
luo: (Çince luo), buhurdan (?)
lurzi: topuz, sopa
Luşanta: kişi adı
luu: (Çince lung), (Moğolca lū), ejdarha, timsah
lüvaŋ: bkŋz; livaŋ
Lükçüŋ: yer adı
ma: ve, ise, bilhassa, bizzat, keza, dahil
madar: şeytan
Madraspant: Manihay tanrılarından birinin adı
Mağabali: şehzade adı
Mağadivi: şehzade adı
Mağaradi: kral adı
magaras: (Sanskritçe Mahārāja)
Mağastvi: şehzade adı
maidun: (Sanskritçe mithuna), bir yıldızın adıdır
Maitri: (Sanskritçe Maiterya), özel bir adıdır
Mahay: bir kralın adıdır
mahistak: Manihey ruhanilerinin bir sınıfı, bir bölümü
mahoragi: büyük yılan
makara: (Sanskritçe makara), bir yıldız adı
makaraç: (Sanskritçe maharaja)
Makintrasini: bir kralın adı
mama: kadın
Mamat-Çin: özel ad
man: (Çince man), dolu, dolmuş
mana: bkŋz; Colocasia İndica
maŋ: adım adım yürümek, adım, gidiş
maŋa: bana
maŋala-: adım atmak, adımlamak
maŋçı: avcı, izci
maŋgal: ad, şöhret, şan, ün, takdis, saadet, kutlama
maŋi: büyü, sinir, tılsım
maŋra-: bağırmak, inlemek, bkŋz; möŋremek
Mani: Mani
manistan: durak, durma yeri, ikamet yeri
mansız: alçak gönüllü, mütevazi, çekingen, muti
mantal: (Sanskritçe mandala), tılsım, sihit
mantali: bkŋz; mantal
mantra: (Sanskritçe), söz, sihir
manu: yabani bir hayvan, istep kedisi
mar: öğretmen
Mar Amu: Maninin öğrencilerinden biri
Mardaspont: (Man. Soğdca Mardāspand), unsur, eleman
marım: aza, uzuv
Masar: kişi adı
Masmadar: kişi adı
Mataŋa: (Sanskritçe), fil
naga: (Sanskritçe nāga), ejderha, yılan hükümdarı
nağıd: zühre yıldızı, akşam yıldızı, çoban yıldızı, sabah yıldızı
nağram: Soğdca ayının 30.günü
nairiti: (Sanskritçe Nairrti), güney-batıdaki saha aralığının adıdır
naivasiki: bkŋz; nivaziki
naivaziki: yüksek ruhlu kimse
nakapuşp: bir çiçek türü
namo: (Sanskritçe namas), tanzim, hürmet, saygı
namo but: Buda'ya hürmetler olsun
namo darm: akideye hörmetler olsun
namo saŋ: rahipler topluluğuna hörmetler olsun
nara: nar (yemiş), (Sanskritçe naraka), cehennem
Naranta: ejderha şahının adı
narayan: Bodisatvanın adı
naru: öteye, oraya
narun: Naruan adlı bir ağaç çeşidi
navsrdiç: Soğdıların ilk aylarının adı
nayut: çağ, devir, (Sanskritçe nayuta), namütenahi, sayısız, hesapsız
ne: ne, hangi, nasıl
neçe: nekadar, kaç, nasıl, herhangi
neçe neçe: her, nekadar
neçeketegi: her nekadar
neçekleti: bkŋz; neçükleti
neçete: hemen, derhal, derakap
neçük: nasıl
neçükin: nasıl, ne suretle
neçükledi: neden, nasıl, neden dolayı, ne suretle, hangi sebeple
neçükleti: bkŋz; neçükledi, niçin, nasıl
negü: nasıl, niçin
negüde: ondan dolayı
ne gegü: herhangi
negüke: ne maksatla, niçin
negüme: herhangi, bir şey, ne olursa
negül: nasıl [negü ol]
negülüg: niçin, nasıl
negülük: bkŋz; negülüg
neke: niye, niçin
nekdi: bir çeşit yılan
nekim: bunun gibi, keza, hangi
nelük: niçin, nasıl, ne gibi
neme: ne, hangi
o: o (zamir)
obratı: anlamı bilimiyor
oçak: ocak, bkŋz; oçuk
oçuk: ocak, ateş ocağı
od: bkŋz; ot
Odçı Buyruk: kişi adı
odğurak: kesin, açık, sarih
odğur-: bkŋz; udğurmak, uyandırmak
odğuratı: kesin, kati, tam anlayarak
odun-: uyanmak (uykudan), kendisine gelmek, hatırlamak
oduğ: uyanık
odun: günahlı, kabahatlı, suçlu
oduruğ: bkŋz; oturuğ
oduz: bkŋz; otuz
Oğan: Allah, tanrı
oğat-: uyandırmak
Oğıl: özel ad
oğlağu: şefkatlı, nazik, nahif, zarif
oğlak: oğlak, keçi yavrusu
oğlan: genç adam, oğlan, çocuk
oğlanğu: çocuk gibi davranılan, nazik
oğr: bkŋz; oğur
oğra-: raslamak, karşılaşmak, birleşmek, niyet etmek, arzu etmek, tertiplemek
oğrayu: hele, bilhassa, özellikle, hasseten
oğrı: hırsız, haydut
oğrın: anlamı bilinmiyor
oğrınta: uğrunda
oğsa-: bkŋz; oğşamak
oğşa-: bkŋz; okşamak
oğul: oğul
Oğul: erkek adı
Oğul-Tigin: erkek adı
oğuluğ: çocuğa air
oğulluk: oğulluk, evlatlık
oğulkıya: çocukcağız
oğur: zaman, vakit, sebep, fırsat
oğura-: niyetlenmek, yapmak, istemek, yapmayı düşünmek
oğurla-: hırsızlık etmek, çalmak
oğurka: iğe kemiği, omurga, fıkra
oğurta: bir zaman, vaktiyle
oğus: bkŋz; oğuş, bkŋz; uğuş
öçür: sönme
öçür-: söndürmek
öd: zaman, vakit, bkŋz; öt
ödirek: ördek
ödki: zamanla ilgili
ödkürgü: bir çeşit ilaç
ödle-: bkŋz; ötlemek
öd-: bkŋz; ötmek, geçip gitmek, zail olmak
öd kolu: zaman, kolu
ödrül-: ayrılmış, seçilmiş olmak
ödsüz: vakitsiz, zamansız
öd [t] ül: öksürük
ödün: zaman, vakit
ödür-: ayırmak, seçmek
ödüş: nemli, ıslak, ratıp, yaş
ög: anne, zeka, akıl, bir çiçek nevi
öge: vekil, nazır, hekim, ün, şöhret
Ögedey: erkek adı
Ögeçük: kişi adı
ögek: çok sevimli, cana yakın, hatırlatıcı, düşündürücü
ögen: çay, nehir
ögdi: medih, sena, övme
ögdilig: methe ve takdire layık, öğüp alkışlamaya değer
ögdir: değer, kıymet, ücret
ögdisiz: takdire layık olmayan, beğeniğ öğmeye değmez
ögdü: övme, takdir, medih, sena
ögdünki: bkŋz; öŋdünki
ögdüş: ağaç yarmaya mahsus ağaçtan çivi, ağaç kama
ögeretig: talim, öğretme, eğitim, terbiye
ögir-: eğlenmek, sevinmek, neşelenmek
ögirtür-: sevindirmek
ögit-: öğmek, methetmek
öglendür-: bkŋz; öglentürmek
öglen-: akıllanmak, kendine gelmek, aklını başına toplamak
öglentür-: aklını başına toplamak
ögli: zeki, akıllı, düşünceli
öglüg: anneli, annesi olan
ög-: düşünmek, meth ve sena etmek, öğüp alkışlamak, ezmek, inceltmek, ovmak, bkŋz; ökmek
ögmiş: övme, meth, sena
ögren-: alışmak
ögrenmiş: alışmış, itiyad edinmiş
ögretig: alışkanlık, adet, bilgi, talim
pa: (Çince po), kırmak, parçalamak
paçağ: oruç
padvahtag: tanrı adı
pahuaiçi: bozguncu, tahrip edici, yıkıcı
pak: bağ, köstek
pakır: bakır
pak-si: (Çince) üstad, alim
pakunsi: (Çince po-chun-sin), bir yıldızın adı
Pançiki: bir şeytanın adı
paŋço: (Sanskritçe) beş
panıt: bal
par: bkŋz; bar, var
parama punya: bkŋz; barm buyan
paramit: bkŋz; pāramita, fazilet, mükemmeliyet
parça: bkŋz; barça
park: bkŋz; bark
paşik: (Himn.hymnus), milli marş
patar: (Sanskritçe pattra), kitap sahifesi
patıl-: bkŋz; batılmak
patir: (Sanskritçe pätra), kase
Patmavati: kız adı
patpadhi: biber
pek: pek, sağlam berk
periken katun: peri kraliçesi
pdek: (Sanskritçe pādaka), manzume parçası
pış-: bişmek, yetişmek, olgunlaşmak
pışrun-: olmak, kemale erişmek, öğrenmek, ısınmak
pışrunmaklığ: heyecanlanan, hisseden
pışur-: bişirmek
pi: (Çince p'ing), düzlük, yazı
piçek: bıçak
pidpidi: bkŋz; pitpidi
pii: (Çince pi), kapamak, engellemek
pinvat: (Sanskritçe pindapāta), sadaka
piriaŋu: bir bitki 'Agalia roxburghiana'
pit: Fırça, bitimek 'yazmak', bitig 'kitap'
pirök: bkŋz; birök
pramit: (Sanskritçe pāramitā), bir sutranın adıdır
pratikabut: (Sanskritçe pratyekabudha)
raçabumi: (Sanskritçe rajahūmi), padişah adı
radna: bkŋz; erdini
Rağu: Rağu, Rağu'nun güneş ve aya hücumile hasıl olan güneş ve ay tutulmasının müsebbibi sayılır
rahu: (Sanskritçe rāhu), seyyare
Raimast: özel ad
Rakakavini: kadın adı
Rakakayini: kadın adı
Raksas: şeytan adı
rem: birinci ayın adı
rand: bkŋz; Arhant
rasayan: hayat iksiri, (Sanskritçe rasāyana) adlı bir eserin adıdır
Ratıkri: özel ad
ratna: bkŋz; erdini
Ratmadivi: Buddanın adı
Ratnakuşpi: Tanrı adı
Ratnaraşi: özel ad
Ratnakar: Bodisatva adı
Ratnakr: bkŋz; Ratnakar
Ratnakkr: bkŋz; Ratnakar
Ratna-vaçir: özel ad
razvrt: lacivert
rhant: bkŋz; arkant, (Sanskritçe arhat)
rivadi: (Sanskritçe revati), yıldı kömesi
roç: (Soğdca rōç), gün
roşn: bir ilaheninin unvanı, (Farsça) ışık
Rtnakr: bkŋz; Ratnakar
rtni: bkŋz; ratna, bkŋz; erdini, mücevherat
rzvt: bkŋz; razvrt
sa: şato
sab: bkŋz; sav, söz, sav
saba: bir ilaç adı
sabçı: bkŋz; savçı
Sabı Buğa: kişi adı
Sabın Satı: kişi adı
Sabutu: kişi adı
saç: saç
saçal-: bkŋz; saçılmak
saçığ: kurbanlık olarak saçılan herhangi bir şey, bir kurban türü
saçıl-: saçılmak, dağıtılmak
Saçiu: özel ad
saçlığ: saçlı
saç-: saçmak, dağıtmak
Saçu: özel ad, lakap
saçuk: saçık, dağınık
sadabiş: bkŋz; satabiş
sadarma: (Sanskritçe saddharma) kitabının adı
Sadı: kişi adı
sadığ: bkŋz; satık
sad-: bkŋz; satmak
sadu: (Sanskritçe sādhu), iyi
sadun: bkŋz; satun
sağ: sağ, sağlam
sağdıç: hesap
sağdıçlığ: mensup olmak, ilgili, ait, müteallik
sağınç: bkŋz; sakınç
sağın-: bkŋz; sakınmak
sağır: sürgün avında, hayvanların biriktikleri yer
sağış: sayış, sayma, rakam, numara
sağızğan: saksagan adlı bir yıldız, saksağan
sağlan-: uyanık olmak, dikkatli olmak, sağlamlaşmak
sağlantur-: saklamak, muhafaza etmek
sağlığ: sağmal, sağılan hayvan
Sağlık: özel ad
sağ-: sağmak
sağ yağ: tereyağı
Sal-Buğa: erkek adı
Saida: kişi adı
sai-: delmek, deşmek, sançmak
sak: özenli, dikkatli, itinalı
şabi: şakirt, öğrenci, talebe, tilmiz
Şağam: Suriye
şahbuhrğan: (Farsça şāhbuhragān), 'mani'ye ait bir eserin adı
Şaki: (Sanskritçe şākya), bir kabile adı
şakimun: (Sanskritçe sākyamuni), lakaptır
şakşamani: (Sanskritçe siksamāna), akaid öğrenen kadınlar
şakşı: pislik
şal: (Sanskritçe şāla), kulübe
Şamız Tayışma: kişi adı
şamnanç: zahide, rahibe
şamnu: bkŋz; şmnu
Şariputri: Sariputra
şarır: (Sanskritçe sarīra), Bakkiyye-i şerif
şarira: kutsal emanet
şasatr: bkŋz; şastr ~ şastar
şastar: bkŋz; şastr ~ şasatr
şastr: (Sanskritçe şāstra), din dersleri, din ve akaid kıtabı
Şastrakariki: bkŋz; erkek adı
Şastrapiry: (Sanskritçe Sāstrapirya), erkek adı, bkŋz; sastras, seven kişi
Şaşı: kişi adı
şaşıl-: şaşılmak
şaş-: şaşmak
şatabiç: ayın bir menzili, (Sanskritçe şatabhişa)
şatu: önder, rehber, idareci
şazana: (Sanskritçe şāsana), din, akide, disiplin
şazın: bkŋz; şazan
şbara: alaca renkli, (Sanskirtçe şabara)
şeker: şeker
şenük: Platane, bkŋz; şünük ~ şnük
şeşil-: çözülmek
şımnanç: rahibe, zahide
Şıŋğur: kişi adı
Şıla atidi: kral adı
Şılabadri: kişi adı
şımtağ: miskin, tenbel, ihtimal
şımta-: serbest bırakmak, salıvermek
şış: bkŋz; şiş
şış-: bkŋz; şişmek
şıvaçır: bkŋz; suvatçır
Şilazin: erkek adı
şiŋ: (Çince schēng), litre
Şinkur: kişi adı
taban: bir çeşit bitki, dağ geçidi
tabar: bkŋz; tavar
Tabğaç: bkŋz; Tavğaç
tabığçı: bkŋz; tapığçı
tabığsak: tapınan, hizmette kusur etmeyen, saymasını bilen
tabılku: bir çeşit bitki
tabın-: tapınmak
Tabırtı: kişi adı
tabla-: tapmak, hizmet etmek, saymak
tab-: bkŋz; tapmak, bulmak
tabra-: çoğalmak, artmak, ilerlemek
tabran-: davranmak, telaşlanmak, acele etmek
taç: taç
Taçadan: kişi adı
tadun: dana
tağ: dağ, dağ silsilesi, sıradağ, kuzey, şimal
tağai: dayı
tağam: bkŋz; tam
tağar: torba, dağarcık, dağar
Tağarmıy: özel ad
tağsut: şiir, nizam
tağsur-: şarkı söylemek, ırlamak, bkŋz; tağşurmak
tağşur-: ırlamak, türkü söylemek, bkŋz; tağsurmak
tağşut: manzume, şiir
tağu: tavuk
tağun: riya, yaltaklık
tağunçı: prensin sadık ve emin tabaası, yaltakçı
tağunla-: yataklık etmek
tağurak: süretle, acele, ivedi
Tai: kişi adı
Taibu: kişi adı
Taiçi-tulun: kişi adı
Tai-çiŋ: Mançu hanedanının (1644 - 1911) adı
Taidık-Alçi: kişi adı
Taidsaŋ: kişi adı
Taisi: bkŋz; taişi
tai-sui: müşteri yıldızı, (Çince t'ai-suei), büyük yıl
Taişi: kişi adı
taişi: prens, şehzade
taişiŋ: büyük taşıt aracı
Taito: 618 - 907 tarihlerin devlet idaresini elinde tutan Çin sülalesi
u: uyku
ubu: üstübeç
uç: uç, baş, uzak
uça: sırt, arka, kuyruk, kuyruk sokumu
Uçayan: yer adı
uçluğ: uçlu
uç-: uçmak
uçkur: mütehassis, uzman, bilirkişi
uçruğ: doruk, uç, zirve, baş
uçruğluğ: yükselik, zirve, doruk
uçsuz: sonsuz, uçsuz bucaksız
uçuğma: uçan
uçuk: çorap
uçuru: talebetme
uçuz: kolay, ucuz, hafif, az, ihmal edilmiş
uçuzla-: değerden düşmek, ucuzlamak
ud: sığır, inek, öküz, onikili hayvan takviminde bir yılın adı
udaçı: yapıcı, muktedir, kadir, gücü yeten
udağsık: hürmete layık, hürmetli, adlı sanlı, saygı değer
udarabatiravat: bkŋz; utarabatiravat
udçı: sığırtmaç, çoban
udğuratı: tamamıyla, hep
udğur-: uyandırmak, arkasını bırakmamak, galebe çalmak, yenmek
udı-: uyumak
udık: uyku
udıkla-: uyuklamak
udluğ: uyluk, kalça kemiği
ud-: ardından gitmek, takip etmek, uymak, birisinin idaresi altına girmek
Udmış: kişi adı
udru: aksine, tersine, bilakis, bkŋz; uduru
udrun-: bkŋz; utrunmak
udu: maiyet, sonra
uduğ: tabi olma, tabiiyet, uyrukluk, uyduluk, hürmet, saygı, ihtiram
uduğsak: davranma
udumbar: (Sanskritçe Udumbara), incir ağacı çeşitli ve meyvesi
udun-: hürmet, ihtiram etmek, tapınmak, saymak, teslim olmak, takip etmek, ardına düşmek, peşine takılmak
udundur-: taptırmak, tapındırmak, hürmet ettirmek, saydırtmak, bkŋz; udunturmak
udura: hisse, pay, parça, bir şeyin yarısı
uduru: tersine, aksine, bilakis, karşı karşıya
udus-: bkŋz; uduzmak
uduş: takip etmek, ardından gitmek
uduz: uyuz
üç: üç
üçegü: üçü bir arada
üçkil: üç köşeli, Zauberritual
üçügü: bkŋz; üçegü
üçün: için, sebep, dolayısyla
üçünç: üçüncü
üçünçi: üçüncü
üçür-: söndürmek
üdlen-: sevinmek
üge: bkŋz; öge, nazır, vekil
ügin: bkŋz; ügün
ügmek: yığınak, köme
üglit-: çoğaltmak, bkŋz; üklitmek
ügra: bulamaç, öz, lapa
ügün: köme, yığın, toplu halde
ügür: sürü, cemiyet, topluluk, soysop birliği
ügüş: bkŋz; öküş
ügüz: bkŋz; ögüz
ükli-: büyümek, gelişmek, neşvünema bulmak
üklit-: artırmak, çoğaltmak
ükül: artış, artma
ükün: yığın
üküş: çok, bkŋz; öküş
üküz: deniz, bkŋz; ögüz
Ülegür: kişi adı
Ülem: kişi adı
üle-: parçalamak, bölmek, taksim etmek, paylaşmak
üleş-: paylaşmak
üleştür-: paylaştırmak
ülez: sönük (güneş)
ülgü: hisse, kısım, parça, pay, ölçü, miktar, adet, sayı
ülgüle-: ölçmek
ülgülençsiz: ölçülemeyecek kadar, büyük, hadsiz, ölçüsüz
ülgüsüz: hadsiz hesapsız, sayısız, bkŋz; ülküsüz, nasipsiz, kısmetsiz
ülker: ülker yıldızı
ülküsüz: bkŋz; ülgüsüz
ülüg: kut, saadet, pay, hisse
Ülügdü: kişi adı
ülüglüg: kutlu, bahtlı, mutlu, unvan
ülüş: hisse, pay, parça, bölüm, kısım
vıçğa: ökse çubuğu
Vadzivanta: bir tanrı adı
vaçir: (Sanskritçe vajra)
vaçrazan: bkŋz; vajrasana
vada: Ficus indica
vahşega: bkŋz; vakşik
vahşig: bkŋz; vakşik, bir ruh
vahsik: bkŋz; vahsig, iyi ruh
Vaibaş: bir şastranın adı, (Sanskritçe vaibhâsâ)
vaiduri: (Sanskritçe vaidûrya), tezyinat taşı, süs
Vaişali: (Sanskritçe vaisâli), kuzey Hindistanda bugünkü Patna şehrinin kuzeyinde bir şehir adı
Vaişravani: (Sanskritçe Vaisravana), bir tanrı
vaituri: bkŋz; vaiduri
vakar: bkŋz; vrhar, bkŋz; vihar
vakşik: ruh, kut, ilah
Vaphuaki: Şastra adı
Varukdad: kişi adı
vasik: (Sanskritçe vâsaka), güzel kokulu bir madde
vayturi: (Sanskritçe vaiduri), kaya billuri
vçir: şimşek, bkŋz; vajra, bkŋz; vaçir
vhşik: ruh
Vidankasari: kişi adı
Vidya: kişi adı
vihar: bkŋz; vrhar, bkŋz; vakar
viman: (Sanskritçe vimâna), tanrı arabası
Vinayaki: bir ilah adı, (Sanskkritçe Viyanaka)
vine: (Sanskritçe vinaya), rahiplere mahsus tüzük
Vipulaçantri: şehzade adı
viraga: yanlız, metruk, münzevi
virana: Andropogon muricatus (ilaç olarak)
virudaki: (Sanskritçe virûdhaka)
Virupakşi: (Sanskritçe) bir ilah
visay: (Sanskritçe visaya), düşünme organı
vişailığ: bkŋz; fişailığ
vişak: (Sanskritçe visâkha), bir yıldız adı
Vişikülen: bir şastra adı
Vipaşi: (Sanskritçe Vipasyin), yedi burhandan birinin adı
viyakiyan: (Sanskritçe Vyakhyâna)
vrhar: (Sanskritçe Vrsçike), bir yıldızın adı
ya: yay, nida, ünlem
Yabasun: kişi adı
yabaş: yavaş
Yabatu: kişi adı
Yabdu Tirek: kişi adı
yabın-: örtmek, örtünmek
Yabıra: kişi adı
yabız: bkŋz; yavız, kötü
yablak: bkŋz; yavlak, kötü, fena
Yabunsu: kişi adı
Yaburşu: kişi adı
Yaçankır: kişi adı
yad: yad, yabancı, bkŋz; yat
yadağ: yayan
yadal-: bkŋz; yadılmak, uzamak (saç için), yayılmak, dağılmak
yadçı: sihirbaz, büyücü, efsuncu, yadacı
yadıl-: yayılmak, dağılmak
yadın-: açılmak, itiraf etmek
yad-: yaymak, açmak, gelişmek
yağ: yağ
yağak: ceviz
yağa-: kurban sunmak, bkŋz; yağmak
yağı: düşman
yağıd-: düşman kesilmek, yağılmak
yağıladaçı: mücahit, savaşkan, mücadeleci, savaşçı
yağıla-: düşmanla çarpışmak
yağılığ: düşmanlık
yağıl-: asılı kalmak
yağın: bkŋz; yakın
yağısız: düşmansız
yağış: kurban
yağışlığ: kurbanlık, kurbana ait
yağışlık: kurban sunma yeri
yağıt-: yağdırmak, yağdırtmak, saçmak
yağız: yağız, koyu renkli, kara
yağlığ: yağlı
yağ-: yağmak, kurban sunmak, bkŋz; yağmak
yağmur: yağmur, bkŋz; yamğur
yağuk: yakın
yağukrak: yakınca olan, daha yakın, yakınrak
zahag: tecelli, sudur
Zharia: kişi adı
zeket: zekat
zira: anis, bir bitki
zmuğtuğ: Soğd ayının 28.günü, (Soğdca zmvhtvğ)
zmuran: myrrhe, mürrü safi
Zkariya: kişi adı
Zrua: Zervan (ilah)
zruşç: 
adasız: korkusuz, tehlikesiz, baskı olmadan, baskısız
adırtsız: ayırt etmeden, ayrılmadan
adğançız: başına buyruk, özgür, hür, serbest
adunçsuz: değişmeyen, sabit
ağaz: ağız
ağazlan-: agızlanmak
ağınçsız: sarsılmaz, sağlam, yerinden oynamaz, sabit
ağız: ağız
ağız yel: bir çeşit ağız hastalığı
ağzan-: konuşmak, söylemek, zelaffuz etmek
ahrvznağ: zodiakus
akığsız: akıntısız, akmayan
akınçsız: sabit, yerinden oynamaz, sağlam, muhkem
alkınçsız: eksilmeden, azalmadan, bol, bitmez - tükenmez, sonsuz
amanizi: şeytan adı
aŋsız: ayırmadan, istisnasiz, tümü ile, hep, bütün
aradın azun: ölümle yeniden dirilme (bas badelmevt) arasındaki zaman
Arazan: özel ad, kişi adı
arığsız: murdar, pis, temiz olmayan
arığsızlığ/k: pislik, kirlilik, murdarlık
artak yavuz: bozuk, kötü, perişan, harap
artız-: arkasından gitmek
aruksuz: yorulmak bilmeyen, argın olmayan
asığsız: asılsız, kazançsız, faydasız
aşsız: yemeksiz, aşsız
atız-: bir musiki aleti çalmak, bkŋz; etizmek
atkanğuluksuz: kelepçelenmiyen, bağlanmıyan
atkanmaksız: serbest, bağlanmış olmadan
atsız: adsız, isimsiz
atsız erŋek: serçe parmağın yanındaki yüzük takılan parmak, yüzük parmağı, (Kazakça) atsız barmak
avınçsız: bkŋz; ayınçsız
Kaançanapati: bir şehir adı
adın-: değişmek, başkalaşmak, ayrılmak, taaccüp etmek, hayret etmek, şaşmak
alkınçu: öd'le birlikte, ecel, ölüm saati
ançman: topluluk, halk, cemaat, bkŋz; kuvrağ
bod: boy, halk, cemaat, vücut, boy, gövde
budun: millet, halk, cemaat, ahali
burhan kutınlığ: Budda saadetine erişmek
bursaŋ: küme, takım, gürüh, topluluk, cemaat
hut: kut, saadet
meŋigü: bkŋz; meŋi, ebedi, bengü, ölmez, saadet, sevinç, mübarek
nomla-: vaaz etmek, öğüt vermek, ders vermek, öğretmek
or-: vaaz etmek, koymak
kavut: kut, saadet, görkem, şevket, haşmet
kılınç: iş, icraat, amel
kılın-: bir şeyin yapılması için uğraşmak, icraata girmek
kıv: kut, saadet, ayakkabı
kut: kut, kutlama, saadet, takdis, ruh, haşmetpenah, hazret, unsur, kişi adı
kutad-: kutlamak, saadet vermek, bahtiyar etmek
kutğur-: saadet saçmak, kut vermek, uğur vermek
kutsuz: uğursuz, kutsuz, saadetsiz
kutut-: mesut kılmak, saadet bahşetmek, bahtiyar etmek
kuvrağ/k: cemaat, meclis, kalabalık, toplantı
saŋ: cemaat, halk, topluluk, servet, bir ilaç
sinçau: (Çince hsin-ch'aa), şematik ay sisteminin bir parçası
suu: büyük mutluluk, nüyük saadet, majeste
taŋ: tan, şafak, sabah, bir ölçü, tatlı, leziz, hoş, nefis, (Çince t'ang) büyük salon, şaşma, taaccüp, hayret
taŋla-: hayret etmek, taaccüp etmek, şaşmak, şaşırmak, şafak atmak, sabah olmak, sıkılmak, korkmak
tatığ: aş, taam, yemek, tad
tirin: dernek, topluluk, güruh, cemaat
turuşluğ: müdafaa edilen, savunulan
türüŋ: gayretli, çalışkan, faal
üzme-: itaat etmemek, itiraz etmek
yal: maaş, ücret, aylık
ankabuş: bkŋz; enkebüş
ırab: tanrı, rab
kitab: kitap
alıŋ: aciz kimse, güçsüz kişi
irinçke-: acımak, merhamet etmek
irinçkençüçi: acıyan, merhametli, şefkatlı
isirge-: acımak, merhamete gelmek
muŋad-: acı duymak, iztırap duymak, kederlenmek, şaşırmak
puşuş: acı kaygu, yes
kadğuluğ: acı, dert, kaygulu
kadğuluk: acılık, dertlik, kaygululuk
tarka: acı, ağır
tavra-: acele etmek
tavrat-: acele ettirmek, kovalatmak
terkin: acele, çabuk
tsuyurka-: acımak, merhamet etmek, bkŋz; syurkamak
tvrak: acele, çarçabuk
adınçığ: başka, başkaca, çeşitli, özel, seçkin, mümtaz, üstün derecede, hayrete değer, şaşırtıcı
adırğuluk: ayırılacak, ayıracak
ağ: ağ, iki bacak arasındaki genişlik
ağrıt-: ağrıtmak, acıtmak
ağtaru: çabuk, ivedidilikle, acele, süratle
akuru akuru: yavaşça, sessizce, yavaşçacık
ançakın: zerre kadar, ufacık, minnacık
aşuk-: ivmek, acele etmek
avya: utanç, ar, haya, hacalet
azğına: azacık, azca, çok az
az-kıa: azacık, biraz
but: but, ayak, bacak
butı: (Sanskritçe bhūta), cin, peri, umacı
butluğ: butlu, ayaklı, bacaklı
adrudaçı: bkŋz; adrutaçı
adrutaçı: ayırıcı, ayıran
alaçu: bkŋz; alaçık
amırtğurdaçı: Yatıştırıcı, yatıştıran, teskin eden, bkŋz; amırtkurdaçı
antaça: tam orada, o yerde
ardaçı: bkŋz; erdeçi
arpaça: arpa gibi
aşadaçı: yiyici
avırdaçı: bir şeyin çevresinde dönüp dolaşan
ayaça: avuç, el içi
ada: tehlike, felaket, musibet, bela, başkası, diğer, öteki, baskı, görüm, ihtiyaç
adak: ayak
adalan-: Tehlikeli duruma düşmek, kötü halde olmak, kötü duruma sokmak
Adam: Adem
ada-: adı koymak, adlandırmak, söylemek, bkŋz; atamak, birisine zarar vermek
adan: bkŋz; adın, başkası, diğer, başka türlü, bundan başka
Adar: özel ad
adara: bkŋz; adıra, ayrıntılı, inceden inceye, teferruatlı
adar-: bkŋz; adırmak, ayırmak
adaş: adaş, arkadaş, dost, ei
adaş kadaş: arkadaş, dost, ahbab, soy sop
adayu: sevimli, aziz, değerli, yavru
addın: bkŋz; adın
adın: diğer, başka, başkası, yabancı, yad
adına: (Farsça), cuma günü
adınağu: başka, başkası
adınağuka: başka başka, ayrı ayrı kimseler
adınağunı: başkasını
adınsığ: bkŋz; adınçığ, bkŋz; addınçığ
adınta: diğer taraftan
adır: (Sanskritçe Ardrā yıldızı)
adıra: bkŋz; adara, inceden inceye, derinden derine, etraflı, bkŋz; ödüre, öteberide, orada burada
adırıl-: ayrılmak, ölmek
adırılmaklığ: ayrılmaklı olan
adır-: ayırmak, tefrik etmek
adırt: ayrılık, fark, tıpkı, ayni
adırtık: ayrılık, fark
adırtla-: ayıklamak, ayırtlamak, tefrik etmek
adırtlayu: inceden inceye, derin, teferruatiyle, ayrıntılarıyla
imiti: ilaç yerine kullanılan'Crataegu pinnatifida'yemişi
kpra: ağaç çileği, rubus idaeus
ağırın-: sızlanmak, hafifçe ağrımak, göynemek, yalvarmak, hüngür hüngür ağlamak
ağsan-: bkŋz; ağzanmak, konuşmak, telaffuz etmek
al: alt, alt taraf, al rengi, yol, vasıta, usül, çare, hile, aldatma
alın: alın, ön taraf
altın: altta, aşağıda, altında, alt tarafı
anda: bkŋz; anta, bkŋz; anda munda, her tarafta, ötede beride
aralık: aralık, mesafe
arığ: temiz, arı, saf, kusursuz, mukaddes
arka: arka, bir şeyin arka tarafı
arvış: sihir, büyü afsun
arvışçı: büyücü, afsuncu, sihirbaz
asanki: süre, zaman mesafesi (felsefi terim), devir
aş içkü: toy, şölen, ziyafet
at-: şafak sökmek, tan almak, nişana atmak, silah atmak, nişan almak, vurmak, dövmek, fışkırmak akmak, çağlamak
azlık: azlık, kafi gelmemek
baş: baş, kafa, yara, yara başı, başlangıç, birinci, ilk
bere: mil (mesafe ölçüsü), bkŋz; bire
bilin-: bilinmek, anlaşılmak, açığa vurmak, itiraf etmek
boşuğ: bağışlama, azat, af, kurtuluş, halas
boşu-: bağışlamak (günahı), gidermek, af etmek, kurtarmak
buluŋ: köşe, yön, taraf, cihet, bkŋz; boluŋ, ilaç türü, ölçü, miktar ölçüsü
bürt-: hissetmek, duymak, dokunmak, dokunma, his, duygu, duyu, hafifçe yakmak
çu: (Çince ch'u), giderme, bertaraf etme
ekü: Boğum, Mafsal [tıp]
emter-: teksif etmek, bir nokta etrafında toplamak
eyegü: yan, taraf
iŋir: tan, şafak, fecir, alaca karanlık
irülüg: muvafık, iyiye işaret, uygun, münasip
köden: mısafir, bkŋz; küdan
körk: güzellik, endam, alamet, nişan, biçim, kıyafet, heyet, resim
körkdeş: kıyafette, güzellikte, endamda eş
Hroştag: ilah, tanrı adıdır
Satagiri: bir peri adı
Şyavsagriv: şahıs adı, kişi adı
tiragük: direk
kagat: kağanlar
sagun: sayın
uzag: uzay
sınag: sınav
yayag: yazgı, kader
arnag: ülkü, amaç
kantag: ne
amra: Magnifera İndica adlı ilaçtır
Ançakarm: bkŋz; Açagram
kısığ: kısık, dar, bag, daratılmış olma
ağa: ağabey, büyük kardeş
ağar: ağır, şerefli, oturaklı, derin, fevkalade, olağanüstü
ağarlağ: saygıdeğer, hürmete layık, şerefli
ağdın-: kalkmak, kalkınmak, yükselmek
ağı: servet, varlık, hazine, göz yaşı
ağı barım: var-yok, servet, varlık
ağıçı: hazinedar
ağıçı uluğu: baş hazinedar
ağıl: ağıl
ağıla-: ağlamak
ağılık: hazine, ambar, antrepo, depo, Hintçenin garbha karşılığı olup Badisatva unvanlarında kullanılmıştır
ağına-: arkası üstü yere sürtünmek, debelenmek
ağır: ağır, çetin, şanlı, saygıdeğer, şerefli, itibarlı
ağır ağır: pek ciddi, ağırbaşlı, temkinli, şerefli
ağırla-: ağırlamak, saygı göstermek, ihtiram ve itibar etmek, saymak
ağırlat-: ağırlatmak, hürmet etmek, saydırmak
ağırlığ: saygıya değer, değerli, kıymetli
ağ (ı) rl (ı) ğ: gebe, hamile
ağıs: bkŋz; ağız
ağlık: boş ve ıssız yer
ağla-: ağlamak
ağlağ: bkŋz; ağılık, hazine
ağ-: yükselmek, yukarıya çıkmak, ağmak, kalkmak
ağna-: bkŋz; ağınamak, arkası üstü yere sürtünmek, debelenmek, kıvranmak
ağrağ: bkŋz; ağrığ, sızı, ağrı
ağrığ: ağrı, hastalık, sızı
ağrığlığ: hastalık, sayruluk
ağrı-: ağrımak, hasta olmak, hastalanmak, sayrulanmak
ağrın-: ihtimam etmek, önem vermek, özen vermek
ağrık: bkŋz; ağrığ, hasta, hastalık
ağruk: hasta, bkŋz; ağrığ
ağruş: hastalanma, ağrı, azap, ıstırap
ahıt-: bkŋz; akıtmak
brahasavati: (Sanskritçe Brhaspati), jupiter yıldızı
brahma: bkŋz; ez-rua
Brahman: bkŋz; Brahmana, kişi adı
brahsuvati: bkŋz; brahasavatı
Sartavahi: (Sanskirtçe sarthhavāha), kervanbaşı
svaha: (Sanskritçe svāhā), bkŋz; sva
çhşapatlığ: ahlaklı, ahlak törelerine uyan, saygı gösteren
kölüg: ahenkli, makamlı
adğanğu törü: daha fazla bir hukuk değimi olup, ayıklama töresi, temyiz töresidir
alpırkan-: yorulmadan ısrarla bir şey üzerinde çalışmak, kahramanca davranmak
alp süŋüş: (Sanskritçe Vyāghra), bir ilah (yahut şeytan) adıdır
altun: altın, zühre yıldızının adı, sabah (akşam) yıldızının adı
anantris: (Sansktrikçe anantarya), Günah'ın adıdır
ançame: daha o kadar, bir daha, bkŋz; ançma
ançma: daha o kadar, daha o denli
arı-: temizlemek, temiz olmak, hukuki değerini kaybetmek, gücünü yitirmek, ölçmek, hesaplamak, bkŋz; arılkahu
arta-: bozulmak, mahvolmak, mahvetmek
sansarlığ: ölüm doğum saırası, mevcudiyetin devranı
ai: ay
aiğ: söz
ainç: bkŋz; ayınç
Bokşaitu: kişi adı
nikai: (Sanskritçe nikaya), tarikat, mektep
kai: bkŋz; kay
kaint: bkŋz; kayınturmak
kaitsu: (Çince) parlaklık
Kaitsu: kişi adı
taitsi: şakirt
Tai üge: bir rütbe
moğuç: sihirbaz, majisiyen, kahin
teŋrim: majeste, prenses hazretleri, deha, dahi
ak: ak, beyaz, kötü, fena
aka: büyük kardeş, ağabey
Akaş: özel ad
ak bi: kır at, beyaz at
akdarıl-: bkŋz; aktarılmak
akığ: akış, akma, akıntı, göz yaşı
akığlığ: akan, akıcı
akırla-: ağırlamak
akıt-: akıtmak
akla-: kötülemek, fenalamak, gücü yetmemek, muktedir olmamak
ak-: akmak
Ak pıra: özel ad
akru: bkŋz; akuru
aktar-: dönmek, çevirilmek, aktarılmak, çevirmek, tercüme etmek
aktarıl-: aktarılmak, başı aşağa çevirmek, devrilmek, yuvarlanmak
aktın-: suya batmak, akmak
aktur-: yükseltmek, akıttırmak
akuluğ: bkŋz; ağuluğ
akuru turkuru: doğru, müstakim
adğırak: dağ keçisi, dağ tekesi, geyik
alakır-: bağırmak, çağırmak, görültüye getirmek, ateşli konuşmak, konuşmak, düzensiz duruma düşmek
alaŋadtur-: arıklatmak, zayıflatmak, düşürmek
alaŋu-: yorulmak
alaŋur-: arıklatmak, zayıflatmak, güçten düşürmek, yormak
alakırış-: bağrışmak, çağrışmak
Alban: özel ad, hizmete ödenen bir vergi adı
alçak: alçak gönüllü, mültefit
aldı: bkŋz; altı
aldun: bkŋz; altun
alğın-: kaybolmak, bkŋz; alkınmak
alğu: hep, bütün, hepsi
alğunı: hepsini
alhın-: bkŋz; alkınmak
alık-: bkŋz; alkmak
alıl-: kendisi için almak
alım: borç, borç alınan herşey
alımçı: borç veren
alınç: alan, elde eden
alıŋlığ: alınlı, alnı olan
alın-: elde edilmek, alınmış olmak, kendisi için almak
alış: alış, alış-veriş, ticaret, bir vergi türü
alış-: almak, elde etmek
allığ: hileli, allı
Alka: özel ad
alka-: övmek, methetmek
alkan-: övülmüş olmak, ünlenmek, şöhretlenmek, yemek (hayvanlar için), saldırmak, yok etmek
alkansık: töre kelimesiyle methetmek, övmek
Alkaşı: özel ad, kişi adı
alkat: övme, medih, sitayiş
alkat-: övdürmek, methettirmek
alkğuçu: hırsız
alkığ: uzak, geniş
alkın-: bitmek, tükenmek, azalmak, eksilmek, kaybolmak
alkıntur-: kaybettirmek
amal: bkŋz; amıl, bkŋz; amul, sakin, uslu, yavaş
amarı: başkaları, kimileri, bazı, diğerleri, birkaçı, toplu olarak, özel ad
amdı: bkŋz; amtı
amıl: sakin, yumuşak huylu, uslu, halim, bkŋz; amal
amır-: sakin olmak
amırtğur-: yatıştırmak, teskin etmek
Amıta-ayuşı: Buda adıdır
amrak: sevgili, aziz
amra-: sevmek, aşık olmak, sevme
amran-: sevgi, aşk, sevinç, sevmek
amranmaklığ: sevilmeli, sevilecek olan
amraş-: sevişmek, çok sevmek
amrıl-: yatıştırmak, sakinleşmek
amrıltur-: yatıştırmak, teskin etmek
amru: daimi, devamlı
amsak: zevk, eğilim, temayül
amşu: kurbanlık yemek
amtı: şimdi, bkŋz; emti
amtıkan: şimdi, tam şimdi
amtıkatağı: şimdiye kadar
amtı ok: Hemen, derhal
amtıkına: şimdi
amtıkıya: şimdi
amtıkı: şimdilik
amul: bkŋz; amıl, bkŋz; amal, uslu, halim, yavaş, sakin
amulluk: usluluk, sükünet
amurt-: teskin etmek, yatıştırmak, bkŋz; amırtğurmak, bkŋz; amırtmak
amur: rahat(lık)
an: o
ana: anne
Anant: özel ad, etnonim
ança: bir miktar, biraz, bu kadar, bu türden
ançada: bkŋz; ançata
ançağınça: bkŋz; ançakınça
ançakınça: tam o anda
ança munça: bir şey, bir miktar
ançata: bunun üzerine, ondan sonra, bkŋz; ançada
ançata kin: bundan sonra
ançata timin: tam o anda
ançğınça: bu sırada, eni sonu, nihayet
ançolayu: bkŋz; ançulayu
ançu: değer, kıymet
ançula-: tapmak, saymak, hürmet etmek, saygı göstermek, itibar göstermek, değerlendirmek
ançulasığ/k: layıkile
ançulayu: ancalayın, böylece, bu suretle, bunun gibi
ançulayuma: ancalayın, keza
ançulayuma kalmış: Budda adı
andağ: bkŋz; antağ
andın: ondan, bkŋz; antın
andın kim: ondan sonra, bunun üzerine
andıran: büsbütün, tamamyla
aŋ: En, yüksek gibi büyütme sigasıdır
aŋa: ona
aŋa-: anlamak
aŋar: (Sanskritçe Angaraka), Mars yıldızının adı
aŋayu: uzak, ötede
aŋ başlayu: en başta, ilkin, ilk
aŋ başlayuki: baştaki, ilk, en başta olan
aŋçı: avcı
aŋığ: kötü, fena
kao-çao: (Çince k'ao tscho), kurban için ruh öağırmak
taŋı: Tao mezhebinden olan kimse
tavlı: (Çince tao-li), ana prensip, esas, temel
toyın: rahip, (Çince tao-jen)
ap: her ne kadar, gerek....gerek, ister....ister, tiş
apa: abla, büyük kız kardeş
apam: bkŋz; abam, eğer
apar: avar (etnonim)
apisğop: metropolit
Aprin-çor: bir Türk şehzadesinin adıdır
apsmar: sar'a, tutarık, (Sanskritçe apasmāra)
çhşapat: oruç ayı
ikapuntrak: (Sanskritçe ekapundarika), tanrı diyarı, yer adı
Kalmaşapadi: kral adı
kap: bkŋz; kara, (Çince kia), zırh, torba, paket
kapağ: kapı
kapağçı: kapı bekçisi, kapı muhafızı
kapak: göz kapağı
kapar-: kabarmak
kapçuk: keten torba
kapığ: kapu
kapış-: karşı durmak, asmak
kaplan: kaplan
kap-: kapmak, yakalamak, örtmek
krmaput: bkŋz; krmapt
krmapt: amel, iş ve yapma yolları, (Sanskritçe karmapatha)
sap: sıra
sapağ: sıra, dizi, üstünlük, istifade
sapan: saban
sapala-: sabanla sürmek
ara: ara, orta
Ara Buğa: özel ad, kişi adı
aral: ada
Aram ay: Uygurların yılın ilk ayının adıdır
Ara Temür: erkek adı
aravadana: bkŋz; arayadana
arayadana: manastır
arbala-: büyülemek, sihirlemek
Arçuni: özel ad, kişi adı
Arçuk: özel adı, kişi adı
ardat-: bkŋz; artatmak
ardır: " (Sanskritçe Ārdrā ""bir yıldızın adı"") "
arduk: bkŋz; artuk
ardun: bkŋz; artun
Arğu: yer adı, etnonim de olabilir
arıd-: bkŋz; arıtmak
arık: bkŋz; arığ, ark, çay, çay kenarı
arıl-: ölçülmek, ölçmek
arın-: arınmak, temizlenmek
arırı: "bir ilaçtır ""Terminalie chebuba"""
arış: arı, temiz, pak
arıtı: tüm, tamamıyla, tekmil
arıtın-: arınmak, temizlenmek
arıt-: temizletmek
arkağ: mekik ipliği, atkı
arkaş-: yardım etmek, arka olmak
Arkar başı: bir çeşme adıdır
arkış: Kervan, Haberci
arku: dere, nehir
arkun: nihayet
arkura yat-: çaprazlama yatmak
as: bkŋz; aş
asağ: bkŋz; asığ
asan: sağlam, sıhatlı, esen, (Farsça āsān 'kolay')
Asana: kişi adı
asan tükel: sağ ve selamet, sağ - esen
asanvar: (Sanskritçe asamvarika 'günah')
asğançu: yaltaklanma, ikiyüzlülük, riyakarlık
asğançula-: eğlenmek, alay etmek, istihza etmek, yaltaklanmak, iki yüzlülük yapmak
asığ: ası, kazanç, fayda, istifade, faiz
asığlığ: asılı, faydalı, kazançlı
asıl-: asılmak, artıtılmak
asın-: asılanmak, yararlanmak, faydalanmak, bağlanmak, asılmak
asır-: terbiye etmek
askançula-: bkŋz; asğançulamak
askın: asılmış
askıntur-: astırmak, astırılmış olmak
askuğ: askı, çardak
asla-: yemek [hayvanlar hakkında]
as-: asmak, çoğaltmak, artırmak
asra: alt, alçak, aşağı, alçak gönüllü, mütevazi
Asravağ: bir günahın adı
astur-: astırmak
asu: bkŋz; azu
asur: bkŋz; asuri
asuri: (Sanskritçe asura 'cim, demon, şeytan')
asur-: aksırmak
antada basa: bunun üzerine, bundan sonra
aş: aş, yiyecek, yemek, kurban yemeği, kurbanlık
aşa: aşırı, aşarak, fazlasıyla, aşkın
aşa-: yemek, silip süpürmek, kabul etmek, hürmet etmek, saymak
Aşan: özel ad
aşan-: yemek yemek, gıda almak
Aşan Puka: özel ad
Aşan Toğrıl: özel ad
Aşan Tutuŋ: özel ad
aşat-: tattırmak, yedirmek
aşay: (Sanskritçe āşaya), niyet, gaye, maksat
aşaylığ: niyetli
aşbini: bkŋz; aşvini
aşçı: aşçı
aşçı er: erkek aşçı
aşğançula-: yaltaklanmak, alay etmek
aşğunçula-: bkŋz; aşğançulamak
aşıl-: artmak, çoğalmak, sınırı aşmak
aşla-: yemek yemek
aşlan-: bir şeye göz dikmek, ağzı sulanmak
aşlaşturu: iyice, sağlam bağlamak
aşlık: mutfak
aşlis: (Sanskritçe Aslėsā), bir yıldızdır
aş-: aşmak, çoğalmak, artmak
aşnu: önce, evvele
aşnuça: önce, daha evvel, evvelleri
aşnukan: önceleri
aşnukı: evvelki
aşnurak: evvelki, baştan
aşvini: (Sanskritçe asini), bir yıldızdır
at: ad, isim, ün, şöhret, at, beygir
ata: baba
atağ: bkŋz; atak
atakımsın-: ad, ün, ünlü olmaya çalışmak, yeltenmek
ata-: adlandırmak, ad vermek, çağırmak, seslenmek, bir şeye ait olmak
atan-: adlanmak, adlandırmak, atanmak, tayin edilmiş olmak
atğan-: bkŋz; atkanmak
atın: bkŋz; adın
atır-: bkŋz; adırmak
atırt: bkŋz; adırt
atış: atışma, küfür, kavga
atkağ: bent, kelepçe, bağ
atkağlığ: bağlı, kelepçe, bentli
atkal-: ok atmak istemek, silah atmak
atkan-: kelepçelenmek, bentlenmek
atlağ: bkŋz; atlığ, adlı, şanlı, ünlü
atla-: atlamak
atlan-: atlanmak, ata binmek
atlantur-: ata bindirtmek, atlandırmak
atlığ: adlı, şanlı, ünlü, tanınmış kimse, ad almış, atlı, sipahi, süvari
at öŋ: (Sanskritçe Nāma-rūpa isim ve şekil), Türkçede ise isim ve renk
atruk: bkŋz; artuk
atud: avuç dolusu
at yol: ün, ikbal, söhret
çau: havale
nmau: (Sanskritçe namo)
kaka tau: ilaç olarak kullanılan bir yemiş
kaula: sebze
kunbauçı: musikişinas
kuŋkauçı: bkŋz; kunhauçı, harfe çalan
tauçaŋ: taht
Yausip: bkŋz; Yausif
kuşti: 'Sassurca auriculata', ilaç yerine kullanılır
süksük: saksaul ağacı, odunu, kaloxylon ammadendron
av: av
avant: (Sanskritçe anbant), sebep, illet, esas, temel
avçı: avcı
avıçğa: bkŋz; avıçka
avıçka: ihtiyar
avınçğa: bkŋz; avıçğa, bkŋz; avıçka
avıŋ: bkŋz; eviŋ
avınıl-: kendisini iyi hissetmek
avınt: bkŋz; avant
avır-: dönmek, dolaşmak
avırta: toplum, topluluk, tüm
avış: (Sanskritçe) en aşağı cihennemin adıdır, bkŋz; arvış
avla-: bir şeyi çevrelemek, çevresini dolaşmak, avlamak
Avluç: özel ad
av-: sıhhatta olmak
avınŋ: bkŋz; eviŋg
avyakirt: (Sanskritçe avyāktra), izah edilemeyen, meçhuliyet, belirsizlik, açıklanamayan
bavşın: varis, mirasçı
çav: para
çavık-: güçlenmek, kuvvetlenmek, ün sahibi olmak, meşhur
çavış: bkŋz; çeviş
çavsız: parasız
çın-sav: gerçek, gerçek ve doğru söz, hakikat
Çitavan: bir manastır adıdır
Çitraviri: İndras'ın oğlunun adıdır, kişi adı
ay: ünlem, nida, ey, ay, kamer, ay (30 gün), kişi adı
aya: aya, avuç, el içi, ünlem, nida
ayağ: şeref, itibar, saygı, hürmet
ayağlağ: bkŋz; ayağlığ
ayağluğ: bkŋz; ayağlığ
ayağlığ: şanlı, hürmetli, itibarlı
ayağsız: itibarsız, hürmetsiz
ayak: kez, defa, kadeh
aya-: saymak, saygı göstermek, ululamak, arzulamak
ayanç: saygı
ayançaŋ: saygı değer, hürmete layık, şanlı
ayant: (Sanskritçe Nidāna)
ayat-: saydırmak, hürmet ettirmek, itibar görmek, korkutmak, teftiş etmek
ayatıl-: sayılmak
ay ayaz: aydınlık, mehtablı gece
ayaz/s: ayaz, serinlik
Ay çeçek: kadın kişi adı
ayğuçı: danışman, akıl veren, müşavir, kumandan
ayı: çok
ayığ: kötü, fena, hile
ayığ kılınç: günah, kötü hareket
ayığla-: kötülemek
ayınç: korku
ayınçlığ: korkulu, korkunç
ayınçsız: korkusuz
ayıŋa: aylarça, her ay
ayın-: korkmak, çekinmek
ayıt: öğüt, vaz
ayıt-: söylemek, sormak, fikte etmek
Ayıtmış: özel ad
aykı: aylık, bir aylık
aykır-: haykırmak
Ayluç Tarkan: özel ad
aymanç: korku
aymançsız: korkusuz
ayman-: korkmak, çekinmek
ay-: söylemek, konuşmak, haber vermek
ayna: şeytan
Ay Sılığ: kişi adı [kadın köle adı]
az: az, biraz, (Farsça āz) arzu, heves, bkŋz; azu, yanlış, sürçme, sahv, yanlışlık
azağ: yanlış yola sapmış
azan: (Sanskritçe āsana), sedir
azand: hikaye, masal
azğan: kadın adı
azğur-: yanlış yola götürmek, azdırmak, saptırmak
azığ: azı dişi
azığlığ: az dişi
azık: bkŋz; azuk
azıt-: azıtmak, karıştırmak, karmakarışık bir hale getirmek, düzensiz hale koymak, intizamı bozmak
azkıya: bkŋz; az-kıa
azlan-: hasedetmek, kıskanmak, çekememek, yanılmak, hata etmek, arzulamak
az-: azmak, şaşırmak, yoldan çıkmak
azsız: hırsız, öfkesiz, sakin
azu: yahut, veya
azuça: yahut, yine
azuk: erzak
bazğan: basan, ezan
boğaz: bkŋz; boğuz, boğaz
boğaz bol-: hamile olmak
Boldaz: kişi adı
İşuyazd: Hazreti İsa
Kara Kuŋaz: kişi adı
karaza-ton: rahip elbisesi, papaz giyeceği, cübbesi
kaz: kaz, bkŋz; kas
kazğan-: kazanmak, toplamak, biriktirmek
kazğanç: kazanç
boşğutçı: öğretmen, muallim, mürebbi
soğançığ: sevimli, hoş, iyi, muhabbetli
tıltan-: sebep olmak, müsebbip olmak
törtkil: kare, dörtken, dört köşeli, murabba
yaratığ: süs, bezek, tezyinat, teşebbüs, bir işe girişme, techizat, donatım
sapça: sabca, savca
kobçır: bir vergi adı
Kabda: kişi adı
ilkisiz: başı olmayan, ilki olmayan, başlangıçsız, mebdesiz, esassız, öncesiz
bediz: resim, tasvir, süs, bezek
bedize-: süslemek, bezemek
bedizen-: süslenmek, bezenmek
bedized-: bkŋz; bedizetmek
bedizet-: süsletmek, bezetmek
bedizçi: ressam, taş yontan, hakkak
Bedrün: erkek adı, kişi adı
bedük: büyük, yüksek, ulu, azametli
bedükle-: büyümek, yükselmek
bedüklentür-: büyüttürmek
bedü-: büyümek, çoğalmak
bedür-: büyütmek
bedüt-: büyütmek, yükseltmek
bek: sağlam, sert, pek, berk
bekili: bkŋz; bekini, bkŋz; begni, bkŋz; bekni
Bekine: kişi adı
bekini: Bira
Bekiz: kişi adı
bekira: sağlam, güçlü, kudretli, kuvvetli, açık, sarih
bekle-: kilitlemek, kapatmak, bağlamak
beklen-: bağlanmak, kapatılmak, kilitlenmek
beklet-: bağlatmak, kapatmak
bekliğ: bağlı, kilitli, kapalı
bekrek: pek, yüksek, üstün
beksiz: arık, zayıf, güçsüz, istihkamsız
beküd nek: bkŋz; bekütmek
bekür-: berkitmek, tahkim etmek, takviye etmek
Batra: kraliçe Bhadra'nın adı
kumba: (Sanskritçe kambha), su perisi, su adamı
ustarabatiravat: (Sanskritçe uttarabhadrapada), bir yıldızın adı, bkŋz; udrabatrabat
utrabadra: (Sanskritçe uttarabhadra)
vriş: (Sanskritçe Vrsabhsa), bir yıldızın adı
bı: bıçak, çakı, kesecek alet
bı bıçku: bıçak
bıça: yırtık, yırtma
bıçak: bıçak
bıçğu: bıçkı, bıçak
bıçğuluk: bıçkılı, bıçaklı
bıçıl-: biçilmek
bıç-: biçmek, kesmek
bıçu-: kesmek
bıçuş-: kesişmek
bıdbul: bkŋz; bıtmul, bkŋz; bıtbal
Bıdın: kişi adı
bıkın: kalça
bınık-: iyileştirmek, şifa vermek, tedavi etmek, sağaltmak
bırkara: güney, cenup
bırt-: kırmak, parçalamak, yaralamak, şekil, yön, veçhe vermek
bışar-: bkŋz; büşermek
bış-: olgunlaşmak, pişmek, olmak
bışrun-: olgunlaşmak, öğrenmek, pişmek, pişkin hale gelmek
bışur-: pişirmek
Bıtaybıkı: kişi adı
Bıtru: kişi adı
bıtmul: biber
kabın: bir vergi adıdır, kurut'la beraber kullanılmıştır
kobı: miras hissesi, miras payı, boş
biçek: bkŋz; bıçak
biçin: maymun, on iki hayvanlı takviminin bir yılının adıdır
biç-: bkŋz; bıçmak
bid: bkŋz; bit
bidgeçi: bkŋz; bitigüçi
bidig: bitig, bedük
Bidilkım: bir şehir adıdır
Bikuş Buğa: erkek adı
Bigü: armağan, vergi
bil: bel
bilbağı: belbağı, kuşak, kemer
bilçe: bele kadar, belce
bile: ile, beraber, birlikte
bileg: armağan
bilegü: bileği
bilek: bilek
bile-: bilemek
bilen: bkŋz; bile, bkŋz; birle, ile
bilge: bilge, bilgili kişi, Buğuğ hakanın adıdır
bilgüçi: bilgin, bilen, üstad
bilgür-: bildirmek
bilig: bilim, bilgi, ilim
biliglig: bilgili, bilgin
biligsiz: bilgisiz, cahil
biliksizlik: bilgisizlik, cehalet, ilmi olmayan
bilil-: bilinmek, tanınmak
biliş: biliş, bilme
bil-: bilmek, tanımak
bilsik-: tanınmış, bilinmiş olmak
biltiz-: bildirmek, belli etmek
biltür-: bildirmek
biŋ: bkŋz; miŋ, bin
bintipal: mızrak
bir: bir, cenup, güney
bir bir: birbir
bire: mil (ölçü)
biregü: biri, birinci
biregüsi: onlardan biri
birer: birer, bkŋz; birer ödün, bir defada
birer birer: birer birer
bir ikinti: birbiri, yekdiğeri
bk: bkŋz; bek
yebkin: bkŋz; Yipin
adğan-: bkŋz; atkanmak, bağlanmak
adğar: bkŋz; adğır, aygır
ad-: bkŋz; atmak
adnağu: bkŋz; adınağu, başkası
adra: bkŋz; adıra, bkŋz; adara, ayrılmış
adrıl-: bkŋz; adırılmak, ayrılmak
adrud-: bkŋz; adrutmak
ağsağ: bkŋz; aksak
alŋat-: bkŋz; alŋadmak
altak: bkŋz; altağ
blgü: bkŋz; belgü
blgür-: bkŋz; belgürmek
teblig: kandırmalı
tüblüg: bkŋz; tüplüg
yblak: bkŋz; yablak ~ yavlak
eke: abla
bo: bu
bodastv: bkŋz; bodistv
bodi: (Sanskritçe bodhi), erme, aydınlanma, irfan
bodı-: bkŋz; bodumak
Bodistv: bkŋz; Bodistw
bodistv: Bodnisattva
bodluğ: boylu
boduğ: çivit, boya, kına, heykel
boduğluğ: boyalı, renkli
bodul-: asılmak, bağlanmak
bodu-: asmak, süzmek, yakmak
boğa: boğa
boğağu: kelepçe, bent, bukağu
boğağuçı: kelepçe vuran, cellat
boğağuluğ: boğulmuş, kelepçelenmiş
boğdam: bayatsımak, kokuşmak
boğ-: boğmak
boğuğ: bkŋz; bağuğ
boğuk: boğuk, kapalı
boğuş-: boğuşmak
boğuz: boğaz, hayvan yemi olmak üzere tane halindeki ekin
bok: bok
bokağu: bukağı, bent, köstek, bağ
bokağçı: bukağı vuran, köstekçi
bokak: bkŋz; bukuk
boksut: bkŋz; bokşut
bokşut: talım, kural, kaide, nizam, usul
bokuk: buğuğ, boğaz uru, şiş
bokun-: çekmek, yerleşmek
bokuz: bkŋz; boğuz
Bolçu: yer adı, nehir adı
bol-: olmak
bolulğa-: bkŋz; bululanmak
bolul-: bkŋz; bululmak
Bolun: kişi adı
boluŋ: bkŋz; buluŋ
bögde: hançer
bögre: böbrek
böğü: hekim, ilgili
Böğü han: Uygur hükümdarlarından 759 - 780 tarihinde yaşamış olan kağan
böğülen-: güvenmek, itimat etmek
böğülüğ: bilgelik, alimlik
bögüş: hikmet, marifet, bilgi
bök: zindan
Bökçe: kişi adı
böksik: karın, kaş
bökteg: yardım, inayet
bökte: bkŋz; bögde
bökü: bkŋz; bögü
böl-: bölmek, taksim etmek
bölük: bkŋz; bölüğ
bölüg: bölük, kısım, hisse
böri: kurt, börü
börisiz: yağısız, düşmansız
böşük tüŋür: sıhriyet, akrabalık
böşük körtük: sevgili, dost, aziz
bört-: dokunmak, temas etmek, dokunma, temas
börtül-: değilmek, dokunulmak, temas edilmek
börtün: meçhul, bilinmeyen
börtür-: değdirmek, dokundurtmak, temas ettirmek
böz: bez, pamuktan yapılmış kumaş
bözçi: pamukçu, pamuk bezi yapan kimse, bezci
kalın böz: kaba ve kalın kumaş
Buğuğ: Böğü hakan, bkŋz; Böğü
eyin: böylece, buna göre
hoŋuz: böcek
branas: bkŋz; barnas
Brhmadati: kişi adı
brişti: bkŋz; prişti, melek, firişte
çobra: yün
köbrük/g: köprü
kobrat-: toplatmak
kubrat-: bkŋz; kuvratmak
tebre-: depremek, kımıldamak, sarsılmak, sallanmak, titremek
tebrememki: deprenniş, sallanış, kımıldanış
tebrençsiz: sabit, sallanmaz, sarsılmaz
tebreş-: tepreşmek, kımıldaşmak
tebret-: sarsmak
tebretük: hareket ettrilmiş
yirtebremeki: bkŋz; yirtinçü
barhasuvadi: (Sanskritçe Brhaspati) Jüpiter yıldızı
Barnas: Benares şehiri, bkŋz; Branas, bkŋz; Baranas
burnaç: göğüm, ibrik
Ezrua: bkŋz; (Sanskritçe Brahma)
künçi: ilaç yerine kullanılan 'abrus precatorius' adlı bitki
kakani: 'Abrus prectorius', cilt hastalığı
kığ: pislik, Azeri'koyun pisliği', tezek, gübre
kık: gübre, çörçöp, pislik
tupulğak: sancı (iç), bağırsak sancısı, böbrek ve benzerleri sancısı
yük-: toplamak, derlemek, yığın, dernek, topluluk, pislik, gübre
kabşa-: tereddüt etmek
kabşur-: kavşurmak, kavuşturmak
yüründek: ilaç, bkŋz; yürübteg
bu: bu (zamir)
Buçan: kişi adı
Buçaŋ: bkŋz; Buçan
buçğak: buçak, köşe
buçğaksız: köşesiz, bucaksız
buçuŋ: kaybolmuş alındı, makbuz ve belgenin yerine verilen yenisi
bud: (Sanskritçe Buddha), (Sanskritçe Budha) Merkür yıldızı
buda: üzüm
Budaşiri: kişi adı
budık: bkŋz; butığ, budak, dal
budin: beden
budul-: bkŋz; butulmak
Buğa: kişi adı
buğan: bezelye türünden bir sebze
buğday: buğday
buğu: geyik
bukün: bugün
bukünki: bugünkü
buk: gırtlak, boğaz
buka: boğa
Buka: kişi adı
bukaç: tencere
bukağu: bukağı, köstek, bağ
bukak: bkŋz; bukuk
Bukam Seŋün: kişi adı
bukun: halk, ahali, millet
bukuklan-: yuvarlaklaşmak
bulaŋ: (Çince pulaŋ), veranda
bulak: kaynak, pınar, çeşme, kanal
bular: bunlar
Bulat: kişi adı
Bulayıt: etnonim
bulğağ: bkŋz; bulğak
bulğa-: bulanmak, karmakarışık olmak, karıştırmak
bulğan-: bulanmak, karıştırmak, karışmak, yanılmak
bulğanyuk: karışık, bulanık
bulğanşu: gürültülü, patırtılı
bulğaş-: toplu halde mevcut olmak
bulhak: bkŋz; bulğak
bulıt: bulut
büdi-: dans etmek, ritmil ve zarif hareketler
büd-: bkŋz; bütmek
büdün: bütün
Büdüş: kişi adı
bügri: eğri
bügü: bkŋz; bögü
bügür: kalça
bügüş: hikmet, marifet, bkŋz; bögüş
bükan: bir kavun türü
Bükiŋ: kadın adı
bük-: bükmek
bükül-: bükülmek
bükün: bugün
bükünki: bugünkü
bükünte: bugün
bükür-: su serpmek
Bünül: kişi adı
bür: Tomurcuk
Bürçi: kişi adı
büri: bkŋz; böri
bürit-: bkŋz; bürtmek
Bürkek: kişi adı
Bürlük: kişi adı
Bürt: kişi adı
bürtüglüg: hissedilen, hissetme, duyma, duyu
bürtüş-: birbirine dokunmak
bürü: bkŋz; böri
büşer-: olgunlaştırmak
büşük: bkŋz; böşük
bütgü: defi hacet etmek, dışarı çıkmak, aptest etmek
bütkür-: bitirmek
büt-: bitmek, sona ermek, tamamlanmak, inanmak
bütüd/t: bitme, tamamlama, ikmal
bütün: bütün
bütür-: bitirmek
bütürmüş: prenses lakabı, unvanı
bütürü: tamamıyla, hepsi, topu
kırkın: cariye, karavaş, azap, ıstırap
kusalıŋ: Cardamon
suksumur: Cardomomun' (ilacı), bkŋz; süksümür
tın: can, ruh, cevher, madde, nefes
tınlığ: canlı, ruhlu, insan, yaratık
tınlığsız: cansız, çorak, kimsesiz
tınsız: cansız
tiŋçi: casus, bkŋz; tıŋçı
tirgüd-: canlandırmak, diriltmek
tirgür-: canlandırmak, ihya etmek, diriltmek
tümke: cahil, bilgisiz, zayıf
yaşlığ: canlı, yaşlı, ihtiyar, yaşlı (göz)
adiştit: (Toharca, Sanskritçe adhisthita ~ adhistit; adıştit)
bun: (Soğdca būn), esas, temel
busat: (Soğdca bösantī), (Sanskritçe Upsatha), oruç adıdır
buş-: öfkelenmek, hiddetlenmek, kızmak, heyecanlanmak
kuvak: köylünün efendisine karşı olan mecburi hizmeti
uduz-: sevketmek, götürmek, takibe mecbur kılmak
üzlentür-: kalkmaya mecbur etmek, birisini geçmek, kalkındırmak
körümçi: Kahin, falcı, müneccim, yıldıza bakan
meriçi: (Sanskritçe mleccha), yabani
otğurak: emin, sağlam, muhakkak, mürecceh, yeğrek, üstün
kasuy: iç mogolistanın kervan tüccarları
sart: (Sanskritçe sārtha), kervan, tüccar
yultuzçı: müneccim, yıldıza bakan
yükünç: secde, ihtiram, hürmet, saygı, ululama
yükün-: secde etmek, eğilmek, tazim etmek, ululamak, ihtirama durmak
kın: ceza, işkence, azap, zorluklar, engeller
kına-: cezalandırmak, kınamak, incitmek
kıyın: ceza, tenbih
kızğut: cefa, zahmet, eziyet, zorlama, ızdırap
koz: ceviz, alev, ateş, kor, köz
semegle-: cenaze töreni tertiplemek
tamuluğ: cehennemlik
yarkan: cellat, hafiye, bkŋz; yarğan, ünvan
yiŋ: cerahat, irin
yiriŋkan: cerahat ve kan
yirin-: cerahatlanmak, irinlenmek
çınsu: (Çince chên-ju), (Sanskritçe tathatā), olduğu gibi
çi: Çin, Ch'eŋ, bitmek
puğa: 'Areca Catechu' bitkisi, ilaç olarak kullanılır
kumunsi: (Çince chu-män-sing), bir yıldız adıdır
sep-: hazırlamak, techiz etmek
yaratıl-: hazır olmak, techiz edilmiş olmak, donatılmış olmak
yivek: erzak, yiyecek, donatım, techizat, malzeme
yivig: bkŋz; yivik, donatım, techizat, malzeme, gerdanlık
altınç: altıncı
basutçı: yardımcı, koruyucu, arka hami, teşvik eden
bez: kabarcık, beze
bir-: vermek, yardımcı fiil
bitgeçi: yazıcı, katib
bitigeçi: bkŋz; bitgeçi, katip, yazıcı
çıda: süŋü, mızrak, cıda
çıkra-: gıcırdamak
çıkrat-: gıcırdatmak
çından: (Sanskritçe candana), sandal ağacı
çıvğaçı tor: ağ atıcı, tor kurucu, tuzak kuran gibi manalarda olmalı
çintan: (Sanskritçe candana), sandal ağacı
emgek: izdirap, acı, zahmet
emgeklig: muzdarip, sefil, acılı, ızdıraplı
emgeksiz: rahat, ıdırapsız, zahmetsiz, acısız
evinŋ: yabancı
utmat: cinnet, delilik, çılgınlık, (Sanskritçe unmāda)
yıŋak: cihet, taraf, yön
yilpig: cin, peri, şeytan, hastalık getiren, gülbayani
baştınkı: ilk, birinci, baştaki
birinçi: birinci
boşğutluğ: öğrenci, öğrenen
burçıntur-: eziyet vermek, incitmek
ekinti: ikinci, diğer
ermegü: tenbel, boş, ilhamci
ertigli: ölümlü, geçici, fani
et'üz: gövde, vücut, cisim, fert, şahis
et'üzlüg: gövdeli, cisimli, vücutlu
eviŋliun: incil
huaşin: beliren cisim, değişen vücut
hviştim: unvan (maniheylerde), muallim, öğretici
ikileyü: ikileştirerek, yeniden, tekrar, yine, ikinci
ikinç: ikinci
ikintisiz: emsalsız, eşsiz, ikincisiz, yekta, benzersiz
iltteçi: sevkedici, bekçi, eşlik eden yanında koşulu olan
inçsiret-: tedirgin etmek, üşendirmek, taciz etmek
ir: taş, güney, (Çince ir) on kabileden ikincisi
irpis: kedi cinsinden (şak) denilen hayvan
kuşdı: Costus'adlı bir bitki olup, kötü ilaç yerine kullanılır
artuç: ardıç, Iuniperus communis
ekir: bitki kökü, Acorus calamus
karıl-: karışmak, mezcolmak
esirgençsiz: esirgemeden, cömert, eli açık
bulku-: icra etmek, yerine getirmek, yapmak
irinçülüg: günahkar, suçlu mücrim
kılmaklağ: kılınan, icrası gereken, bkŋz; kılmaklığ
satağsız: ücretsiz, değersiz, parasız
sına-: denemek, sınamak, tecrübe etmek
ter: ter, ücret
terçi: işçi, ücretli
terke: ücret, hakedilen nesne, ter karşılığı
tersiz: bedava, ücretsiz, parasız
yaka: ücret, icar bedeli, kira karşılığı, taraf, yan, civar
aditya: (Sanskritçe āditya), Bir yıldız anlamında olup 'güneşi' ifade eder, cuma günü
bar: var, hep, mevcut
barığ: yolculuk, gidiş, yürüyüş
boyun: boyun, ense, vücut
erikli: bulunan, mevcut olan
er-: imek, olmak, mevcut olmak, var olmak, vuku olmak bulmak, bulunmak, ait, ilgili olmak, deskriptif fiil olarak
ilge-: hücum etmek, saldırmak
isig-öz: beden, gövde, vücut
kenç: genç, civan, yavru (insan için), çocuk
keŋçi: son beşik, sonuncu evlat
kinçuman: (Çince), 12 bölümlü nücum ilmi silsilesi
kövtüŋ: vücut, beden, gövde
közün-: gözükmek, görünmek, kabul edilmek, hazır, mevcut olan, şimdiki
küiduŋ: vücut
miş: (Sanskritçe Mesa), zodiaktaki koç, koç burcu
munçuğ: boncuk, mücevherat, kıymetsiz taş
onunç: onuncu
osuğluğ: gibi, mahiyetinde, yaradılmış, vücuda getirilmiş olmak
oyunçı: çalgıcı, oyuncu
öpün-: hücum etmek
ötgürü: dolaysıyla....., ile......, itibaren, neticesinde, sonucunda, sonra
birkele-: verme kabiliyetinde ve gücünde olmak
evir-: evirmek, çevirmek, tercüme etmek, bir dilden başka dile geçirmek
kiye: küçültme eki halindedir, fakat tekit gücünü de taşımaktadır
küneyiŋi: kıskanç, hasetçi, günücü
kam: şaman, büyücü, sihirbaz
kut-: telef olmak, takatsızlanmak, gücünü yitirmek
savlığ: sözlü, savlı, sözcü
sidi: (Sanskritçe siddhi), sihir, büyü, büyü gücü, sihir kuvveti
sok: hasetçi, kıskanç, günücü, bkŋz; suk
tilimçi: dilmaç, tercüman, mütercim
törünç: dördüncü
u-: muktedir olmak, yapabilmek, gücü yetmek
usar: muktedir olursa, gücü yeterse
yelme: izci, keşşaf, piştar, öncül (asker deyimidir)
tobulğak: 'Cyperus'
ot yem: ilaç, ecza
neŋ: eşya, nesne, asla, hiçbir suretle, ....gelince
İnanççı: kişi adı
çeçek: çiçek
çeçeklen-: çiçeklenmek
çeçeklig: çiçekli
çeçeklik: çiçeklik
çekrek: alttan giyilen, kısa giyim
çekür: çukur
Çeŋez: yer adı
Çeŋin: kişi adı
Çeŋür: kişi adı
Çeŋür Arız: yer adı
çerig: asker, çeri, ordu
çeviş: yol, vasıta, tedbir, hile
çevişlig: hileli
enetkekçe: hintçe
erkimçe: isteğimce, arzumca
inçe: böylece, bu suretle, buna göre, öyle, böyle
inçek: böylece
kezikçe: tertiplice, düzenlice
kiçe: gece, geceleyin
köçe-: bkŋz; küçemek
kögençeŋ: kibirlenen
küçed-: bkŋz; küçetmek
küçek: güçlü, kuvvetli
küçe-: zorlamak
küçen-: zorlanmak, kuvvetlenmek
küçet-: güçlendirmek, kuvvetlendirmek
küvençeŋ: mağrur, kendini beğenmiş
ençgü: barış
ikirçgü: işkil, şüphe, kuşku
inçge: ince
inçgü: bkŋz; inçkü
inçgülüğ: bkŋz; inçkülüğ
kögürçgün: güvercin
yinçge: ince
sırıçga: sırça
tayançgak: dayanak
inçke: bkŋz; inçge, bkŋz; yinçke
yinçke: bkŋz; yinçge
Kakşa Açğı: kişi adı
sıçğan: bkŋz; sıçkan
yılınçğa: ılık
sırınçan: bkŋz; sınçğan
yivet-: donatmak, teçhiz etmek
yivit-: bkŋz; yivetmek, teçhiz etmek, donatmak
yüvig: donatım, teçhizat
çıçamuk: küçük parmak
çığ: bir bitki adıdır, (Çince ç'ik), ayak, litre
çığsız: ölçüsüz
Çığ Batar: kişi adı
çıku: ilaç olarak kullanılan bir taş
çımad: öfke, hiddet, kızgınlık
çımkı-: bkŋz; bıçmak, biçmek, kesmek
çın: gerçek, gerçeklik, doğru
çınbarmak: doğru, gerçek, kesin olarak, tam
çın bitig: gerçek senet ve sözleşme
çıŋ: doğru, gerçek, tam, kesin olarak
çıŋaru: tam, şüphesiz, arzulama, özlem, hasret
çıŋartğu: zil, çıngırak
çıŋar-: araştırmak
çıŋart-: araştırtmak, inceletmek, muayene etmek, tetkik ve tahkik ettirmek
çınık-: tahakkuk edilmek
çınkar: (çınbarmak'tan), dosdoğru
Çıntsu: kişi adı
Çırkuş: kişi adı
Çıtsu: kişi adı
çıvşağun: ekşi
çızdur-: çizdirmek
çızığ: çizgi, hareket tarzı ve usülü
çız-: çizmek, bkŋz; çizmek
Çidin: kişi adı
çigidem: bir bitki
Çigil: etnonim ve yer adı
Çigil Arslan: erkek adı, kişi adı
Çigil Balık: şehir adı, yer adı
Çigil Kent: yer adı
Çiğma: bir hastalık
Çigüi: kişi adı
Çiig Tutuh: memur unvanı ve lakaptır
Çiik: etnonim
Çik: bir halkın adıdır
Çikçi: bir rütbedir
çilteg: itibar, saygı, hürmet
çilte-: hürmet etmek, saygı göstermek, saymak
çim: buruşuk
çimeli: karınca, bkŋz; çömeli
çimbudip: bkŋz; çambudip
çimgen: çayır, çimen
çimsiz: buruşuksuz
çin: bkŋz; çın, gerçek, hakikat
Çinaŋ-kat: dokuz Oğuz yahut Uygurların doğudaki şehirlerinden birinin adıdır
Çinak: kişi adı
Çinatun: kişi adı
Çinek: kişi adı
Çiŋ: 1644 - 1911 yıllarına kadar devlet idaresini elinde bulunduran Mançu sülalesinin ünvanıdır
çintal: bkŋz; çantal
Çintamani: kişi adı
Çisim: kişi adı
Çisün: kişi adı
çişt: (Sanskritçe Iyestha), bir yıldızın adıdır
çiu: yakalama, tutma
çiü: bkŋz; çiu
Çizim: kişi adı
çiz-: bkŋz; çızmak, çizmek
Inçki: kişi adı
inçkü: huzur, sükünet, barış
inçkülüğ: sükünetli, huzurlu, sakin
kögürçken: güvercin
koçkar: koç
Koçkar: kişi adı
sıçkan: sıçan, fare, 12'li hayvan takviminin bir yılı
Sıçkançı: özel ad
sınçkan: musa ağacı, Lycium europeum
sırçka: ayna, cam
tançkıla-: didiklemek, parça parça etmek, kesmek, parçalamak
yornçka: bkŋz; yorunçka
yorunçka: yonca, bkŋz; yornçka
irinçle-: bedbaht olmak
kirtgünçlüg: inalılır kimse, itikadı ve inancı yerinde olan
körünçle-: teşhir etmek, sergilemek
körünçlegülük/g: teşhire layık, sergilemeye değer, göstermeğe değer
körünçlük/g: üzerinde eşya sergilenen raf, pano, iskele
küçlendür-: bkŋz; küçlentürmek, kuvvetlendirmek
küçlentür-: güçlendirmek, galebe çalmak
küçlüg: güçlü, kudretli
ögrinçlig: bkŋz; ögrünçlüg
karınçlığ: hakaret etme, aşağılama
kılınçlığ: kılınçlı, iş yapıcısı
korkınçlığ: korkunç
korkunçluğ: korkunç
sakınçlığ: düşünceli, fikir sahibi, endişeli
sevinçlen-: sevinmek, neşelenmek
sevinçlig: şen, neşeli, sevinçli
yirinçlig: iğrenç, kötü, bkŋz; yirinçülüg
bergek-: kamçılamak, kırbaçlamak
berk: kuvetli, güçlü, sağlam, sık, orman
birimçi: borçlu
birimlig: borçlu
ergü: hane, ev, konak, ikametgah, çok kuvvetli, güçlü
erik: erkli, güçlü, kuvvetli, irade
erklig: güçlü, kudretli, bahadır, hükümdar, hakim, zühre yıldızı
çmbudvip: bkŋz; çambudvip
kiçmedin ara: vakit geçmeden
kiçmetin ara: gecikmeden, derhal, hemen
kaçma: kaçma
kıçmık: atom
Sançmış: özel ad
adru-: seçmek
antık-: yemin etmek, and içmek
arkur-: bir yandan öteki yana geçmek
ert-: geçmek, işlemek, devam ettirmek, peşini bırakmak
irpekle-: biçmek, doğramak
isin-: ısınmak, sıcaklık duymak, değerlendirmek, kıymet biçmek, hürmet, önem vermek
itlin-: kaybolmak, geçmek
kiç-: geçmek
köç-: göçmek
moŋul: kavim adı, hezeyan, saçma, manasız lakırdı, safsata, gecezelik
münük-: üzerinden geçmek, aşmak, mürür etmek
oy-: oymak, delmek, çukur açmak, oynamak
ozakı: geçmiş, mürür etmiş
ozala-: kaçmak, öne geçmek
örmen: geçmez, onmaz bir deri hastalığı
ötgün: ötmüş, geçmiş, mazi
öt-: ekmek, rica etmek, dilemek, keskin olmak, zail olmak, geçmek, peklik çekmek
pükün-: reddetmek, saçmak
kaç-: kaçmak
kay: (Çince k'ai), açmak, bir sülale mensubu
Çoba yıkmış: kişi adı
çoğ: kör, köz, ateş, ziya, alev, parlaklık
Çoğı Tirek: rütbe
çoğlan-: parlamak
çoğ-: bkŋz; çokmak
çoğluğ: ateşli, ziyalı, korlu, nurlu, haşmetli, görkemli
çoğ yalın: parlaklık
Çok adğar: kişi adı
çokan kişi: nişanlı kimse, yavuklu kişi
Çokı: kişi adı
çok-: öldürmek, kesmek [hayvan kişi]
çokra-: kaynamak, galeyana gelmek
çokrat-: kaynatmak
çokurda-: pişirmek, kaynatmak
çol-: sakatlanmak
çoluğ: çolak, sakat
Çoluk: kişi adı
ço-: çomak, kamçı
çomın-: dalmak [suya]
çom-: batmak, dalmak
çomur-: batırmak
çomurmış: sulu şeyleri almağa mahsus kepçe
Çonal: kişi adı
çoŋ: sol
Çor: bir rütbedir
Çosun: kişi adı
Hoço: Hoço şehrinin adı
Koço: şehir adı, yer adı
Türtkil Çok: yer adı
ket: çok, artık, güçlü, kuvvetli, pek
köp: çok, bol
çöbik: çöp, pislik, bulanıklık, boş şekil
çöke: diz çökme
Çökei: kişi adı
çökde: bkŋz; çökte
çökit-: bkŋz; çökütmek
çökle-: çökmek
çök-: çökmek
çökte: kulak arkasındaki çıkık kemik
çöküğ: dizleri çökük
çöküt-: dize getirtmek, diz üzerine çöktürmek
çömeli: karınca
çöp: şekil
küb: çömlek (mayi ölçeği)
seş-: çözmek, bağını açmak
sökü: çökme (?)
şrmiri: çömez, rahip şakirdi
yörül-: çözülmek
çüğte: bkŋz; çökte
çümeli: bkŋz; çömeli, çimeli'karınca'
idiş: kapkacak, çanak, çömlek
ir-: erimek, çözülmek, bkŋz; ermek, karşı gelmek, direnmek, mukavemet etmek, nefisine mağlup olmak
Kögür: gobi çölünde bir yer adıdır, bkŋz; Kügür, bkŋz; Küger
Kömür-tağ: gobi çölünde bir yer adı
körtük: kar yığını, kar sahası, çöl, aşık, seven
kürküm: safran, kirkum, zerdeçöp, hind safranı
küzeç: testi, kazan, çömlek, çanak
öŋ: renk, ön taraf, önce, doğu, sahra, çöl
say: kır, çöl, taşlık, bozkır
sıyuk: enkaz, çöküntü
söklün-: sökülmek, çözülmek, çözümlenmek
çrman: deri hastalığının bir türü
suv içreki: suyun içindeki
balıŋla-: bkŋz; beliŋlemek, birden korkup sıçramak, uykuda korkup sıçramak
kalanğur-: atılmak, oynamak, dans etmek, raksetmek, sıçramak, sevinçten zıplamak
kalıt-: sıçratmak
sigrik: atlama, sıçrama
sikri-: atlamak, sıçramak
bulunçsuz: bulunmayan, bulunmaz, kazançsız, erişilmeyen
evrilinçsiz: sarsılmaz, sabit, sağlam
inçsiz: huzursuzluk, huzursuz, rahatsız
kerinçsiz: eşsiz, kıyaslanmıyacak kadar iyi, aşırı, üstün
kirtgünçsüz: inançsız, itikatsız
küçsire-: kuvvetten düşürmek, zayıf süşürmek, zayıflatmak, güçsüz olmak
küçsüz: güçsüz, kuvvetsiz
okunçsuzın: davetsiz, çağrılmadan
ökünçsüz: nedametsiz, acısız
kalınçsız: bütün, tamamen, kalısız, bakiyesiz
kanınçsız: kanmayan, doymayan
korkınçsız: korkusuz, korkunç olmayan
korkunçsuz: korkusuz
sakınçsız: endişesiz, düşüncesiz, tasasız
teŋlençsiz: ölçüsüz, sayısız, tartısız
todunçsuz: doymaz
totunçsuz: doymak, bilmeden
tözkerinçsiz: temelli olmayan, temelleştirilmeyen
tudunçsuz: hayasız
tutunçsuz: tutulamayan
unçsuz: minnetsiz
ukunçsuz: tedbirsiz
üzlünçsüz: fasılasız, kopmadan, süreli
yanınçsız: dönmeyen, geri gelmeyen
yarlıkançsız: merhametsiz, taş yürekli, şefkatsiz, katı yürekli
yazınçsız: günahsız, yazuksuz
yitinçsiz: ulaşılamayan, erişilemeyen
Çştani: kral Kastana'nın adı
kıçtın: kaşıntı
alŋadtur-: zayıflatmak, arıklatmak, güçten düşürmek
bara: bir ilaçtır, bir tartı ölçüsüdür
köni: dürüst, doğru, sadık, içten, samimi, sahihi, tam, bütünü ile, kova
taştırtı: taşrada, dışarıda, hariçte
üŋür-: deldirmek, deştirmek, delik açtırmak
yavrı-: zayıflamak, eğilmek, güçten düşmek
çubakan: Innap'zizyphus'
çubik: bkŋz; çubuk
çubuyan: hoş ve leziz nesne, tatlı şey
çuğ: bkŋz; çuuğ, bahçe, bağ, demet
Çuğay: Hangay dağlarının güney kolları yöresi
çuğı: gürültü
çulvu: rezalet, kötü şöhret, fena ad, küfür
çumbur-: atılmak, saldırılmak
çur: bir rütbe
çurnı: barut
çuuğ: bulanık
çuv: hisse, pay, tüm
Baruçu: kişi adı
Çüen-tsiu: "Konfuçyus'un ünlü ""ilk ve son bahar"" adlı eserinin adıdır"
Çürşet: bkŋz; Çürçet
çürni: bkŋz; çurnı
çüsüm: dut
çüvit: çivit
ilinçü: gezinti, eğlence
ilinçülegü: eğlenme, eğlence
ilinçülegülüg: eğlenceli, eğlence
ilinçüle-: eğlenmek, oynamak
inçü: devlete ait topraklar, köle
İneçü: kişi adı
İneçük: kişi adı
İrçük: kişi adı
irinçü: günah, kusur, yanlış, hata, kabahat, kötü, çirkin
irünçü: bkŋz; irinçü
irünçülüg: kusurlu, hatalı
kiçür-: geçirmek
köçür-: göçürmek
Küçük Idıkkut: erkek adı, rütbe
Küçük Temür: erkek adı
Küvçü: kişi adı
Küzençük: kişi adı
Mençük: kişi adı
ne üçün: niçin
ot öçüri: ateş sönmesi
arkuru: haçvari, çapraz
antada: ondan, oradan, bundan
antada kisre: ondan sonra, sonda
irin-: bedbaht olmak, kızmak, öfkelenmek, bkŋz; yirinmek
irintür-: bedbaht edilmek, felakete sürüklenmek
kez: sonra, başka, sefil, bedbaht
kovı: kof, boş, oyuk, bedbaht, kısmetsiz, kutsuz
yarlığ: bkŋz; yarlık, emir, ferman, buyruk, yarlık, fakir, yoksul, aciz, bedbaht, sefil, perişan, tarikat, sutra, mukadderat, lutuf
kivan: (Soğdca kēwān), saturn yıldızı
mişi: Soğdca ayının 16.günü
semnu: (Soğdca şmnv), şeytan
tamu: (Soğdca tmv), cehennem
Budda kutunda olan: 
tuddasız: bkŋz; tudasız
adıştit: Mukaddarat, kader, alınyazısı
alp: yiğit, cesur, alp, şiddetli, güç, zor, müşkül
Aryaman: (Farsça aryāmān 'dost'), özel addır
burkan: (Sanskritçe Buddha 'burhan'), aradan, halik, şaman, , ilah, tanrı
erdini: (Sanskritçe ratna), cevher, kıymeti olan her madde ve şey
ısığ: halat, urgan, ip, maddeten, hararet, sıcaklık
kekşür-: hiddetlendirmek, nefretlemek
kikşür-: birine kızmak, hiddetlenmek, öfkelenmek
Maytri: gelecek Budda'nın adı
örle-: hiddetlenmek, öfkelenmek, gürlemek, yükselmek
örlet-: kızdırmak, hiddetlendirmek, incitmek
örüg: bkŋz; yörüŋ, uzun müddet, bengü, ebedi
övke: öfke, hiddet, kızma
övkele-: öfkelendirmek, hiddetlendirmek
övkile-: öfkelenmek, hiddetlenmek
puşan-: kızmak, hiddetlenmek
puş-: kızmak, hiddetlenmek, kaygulanmak, tasalanmak
birdem: büsbütün, tamamıyla
erde: bkŋz; erte
erdeçi: erecek olan
erdem: erdem, fazilet, kabiliyet, güç
erdemlig: erdemli, faziletli, kabiliyetli
erdeni: bkŋz; erdini
Erdeni Katun: kadın adı
igde-: hilekarlık etmek, dolandırmak
igdeyü: al, hile
izde-: istemek
izdet-: arattırmak, istetmek
kider-: bkŋz; kitermek
köde-: bağırmak
körkitdeçi: gösteren, klavuz
közünürdeki: görünürdeki, şimdiki
küdegü: güveyi
küde-: bağırmak, çoğırmak, gürültü etmek
küden: misafir, konuk, ig'le birlikte 'kalın' bağırsak hastalığı
küdenlik: konak, misafire mahsus ev
kündem: güneşe benzer, güneş gibi, parlak, güneşli
mindide: benden
Ogüdey: Moğul hanının adı
sintede: senden
teŋridem: ilahi, semavi
tŋridem: ilahi, semavi
üskiŋde: bkŋz; üskinte
etgü: bkŋz; edgü
adğanğu: temyiz, tefrik, ayırt etme, ayıklama
adğır: aygır
adğırlık: yılkı, hara
kadğu: kaygu, acı, dert
kadğur-: kaygulanmak, kederlenmek
todğur-: doyurmak, bkŋz; totğurmak
katku: bkŋz; kadğu
kayğu: bkŋz; kadğu
totğur-: bkŋz; todğurmak
anurat: (Sanskritçe Anurādhā), bir yıldızın adı, bkŋz; anurad, bkŋz; anurd
intradanu: (Sanskritçe indradhanu), ındrasın yayı
kent: (Sgd.kndh (kanth) ), şehir
samar: (Sanskritçe samādhi), geçit, nazar
tarmadan: erkek adı, (Sanskritçe dharmadhana)
tatu: (Sanskritçe dhātu), natür, tabiat
töre: (Sanskritçe dharma)
utraşadi: (Sanskritçe uttarasadha), yıldız adı
antırdın: oradan
basdık-: bkŋz; bastıkmak
başdınkı: bkŋz; baştınkı
badiz-: süslemek, bezemek
berdinki: güneydeki
birtemledi: tamamladı, bütünledi
adlığ: adlı, şanlı, şöhretli, ünlü
yıdlağ: bkŋz; yıdlığ, kokulu
yıdla-: koklamak
yıdlığ: kokulu, rayihalı
Alp: özel adlara eklenen rütbe, lakap
küülüg: bkŋz; külüg, ünlü, şanlı, adlı, şöhretli
otluğ: ateşli, odlu
sıçılığ: çevrili, sınırlı, hududlu
tıdığlığ: manialı, hududlu, engelli
ti-: demek, söylemek, dilemek, hazırlamak, nutuk, konuşma, mükaleme, adlanma
tit-: teberru etmek, bağışlamak, vermek, adlandırılmak, değerlendirilmek
uluğ atlığ: adlı, sanlı, kimse
yıtlığ: bkŋz; yıdlığ
yüzlüg: akraba, aziz, muhterem, adlı sanlı kimse, yüzlük, yüze dahil olan, yüzlü
Kutadmış Pars: kişi adı
Tedmilig: kişi adı
eşit-: bkŋz; eşidmek
hudatmış: unvan, rütbe, kutadmış, kişi adı
ıt-: bkŋz; ıdmak
işid-: bkŋz; işitmek ~ eşidmek
küd-: bkŋz; kütmek, güdmek
küt-: güdmek, bakmak, itina göstermek, özen vermek, beklemek
küzed-: bkŋz; küzetmek, güdmek
öŋet-: bkŋz; öŋedmek
kot-: bkŋz; kodmak
koy-: bkŋz; kodmak
sut-: bkŋz; sudmak
tıt-: bkŋz; tıdmak, parçalamak, ayırmak, uzaklaştırmak
ulğad-: büyümek, neşvünema bulmak, bkŋz; uluğadmak
uluğad-: yaşlanmak, kocalmak, bkŋz; ulğadmak
yaltrıt-: parlatmak, aydınlatmak, bkŋz; yaltrıdmak
yeged-: bkŋz; yigedmek
yoğad-: bkŋz; yokadmak
yokat-: bkŋz; yokadmak
yüt-: yüklemek, taşımak, bkŋz; yüdmek
erdni: bkŋz; erdini
erdnilig: bkŋz; erdinilig
emçi: doktur, hekim
itiglig: donatılmış, mücehhez, hareketli
iyin: dolaysyla, olduğundan dolayı, göre, kendi isteği ile, gönüllü olarak
kirtü: doğru, gerçek, sahih, mümin, imanlı, mutekid
muntur-: dolaştırmak
otaçı: doktor, hekim, tabip
öŋdüri: doğuda, şarkta
Purum: doğu Roma
kanamlağ: doymuş, tok, bkŋz; kanamlığ
kudas: dost, ahbap, arkadaş
tapa: doğru, yönelmiş, yönetilmiş, karşı
tod-: doymak
todur-: doyurmak
toğ-: doğmak, doğuş, bkŋz; tokmak
toğra: doğru
toğrul-: doğranılmak, parçalanmak
toğsuk: doğuş
toğum: doğum, devellüt
toğurğuluk: doğurma, doğum zamanı
toğur-: doğurmak, atlamak, ilerilemek, tecavuz etmek
toku-: dokumak, vurmak
tokuz: dokuz
tokuzunç: dokuzuncu
tola-: dolamak, çevirmek, bkŋz; tolğamak
tolun: dopdolu, hep
tomludu: doğru, dürüst, adilane
tona-: donatmak, çekidüzen vermek, geydirmek
toŋuz: domuz, onikili hayvan takviminin bir yılı, kurt, böcek
toŋuzçı: domuz besleyen
tonluğ: donlu, elbiseli
ağtarıl-: dönmek, eğilmek
evriş: dönme, dolaşma, çevirme, iş güç, hal, hareket, meşgale
kinlen-: dönmek, çevrilmek
kavrış-: döğüşmek, kavga etmek
sok-: dövmek, ezmek, delmek, ufaltmak, sokmak, basmak
tegrikle-: dört yanını çevrelemek, kuşatmak, ihata etmek, çevreye dizmek
tegzindür-: döndürtmek, çevirtmek
tegzin-: dönmek, dolaşmak, devir yapmak, daire çizmek, bkŋz; teksinmek
toŋtar-: dönmek, çevirilmek
tök-: dökmek, dağıtmak
tökül-: dökülmek, bkŋz; tögülmek
tökün: dökülmüş
töl: döl, nesil, torun, zürriyet
tört: dört
törtdin: dört tarafdan, yandan
töşek: döşek, yastık (?)
töşe-: döşemek
töşen-: döşenmek, kullanılmak
tüşek: döşek
ursuk-: dövülmüş, vurulmuş olmak
buta-: budamak, vurmak, dövmek, kesmek
evril-: evrilmek, dinini değiştirmek, çevrilmek, dönmek
evrilme-: çevrilmemek, evrilmemek, dönmemek
opu: burgaç, dölembeç, girdap, çarh
kadıt-: çevirmek, indirmek, döndürmek
sürdüştür-: ezmek, döğmek
teglir-: çevirilmek, döndürülmek
tegre: daire, çevre, civar, dört taraf
tevir-: devirmek, çevirmek, döndürmek
tevril-: devrilmek, dönmek
tokı-: vurmak, dövmek, ezmek, tokmaklamak, sokmak, tepinmek
adruk: artık, başka, olduğu gibi, tamamıyla
adruk adruk: ayrı ayrı, her türlü, türlü türlü
adrut-: ayırmak
irpis kudruğu: bir yıldızın adıdır
ksudra: küçük, ufak
kudruğ/k: kuyruk
sedrek: seyrek, ince
sedreksiz: seyrek olan, sık olmayan
şrinalandrm: bir manastir adı
yıdruk: yumruk
kıdığsız: hududsuz
kolti: (Sanskritçe koti), sayısız, hesapsız, hadsiz
sansız: sayısız, hadsiz hesapsız
tatığsıra-: tadım kaybetmek, tadsızlanmak
kökedtür-: methettirmek, övdürmek
muŋadtur-: şaşırtmak, hayrete düşmek, kederlendirmek
kodtur-: koydurtmak, yerleştirtmek
aduğ: ayı
adurt: avurt, yanak
adut: avuç, avuç dolusu
boyunduruk: boyunduruk
mudur: (Sanskritçe mudrä), tamga, mühür
munça koduru: tamamıyla, tamı, bütünüyle
oŋdun: sağdan
ordu: saray, oda, ordugah
Ordu beg: özel ad
Orduk: kişi adı
kadun: bkŋz; katun
kadur-: pişman olmak
Kambukdu: kişi adı
bir ödün: yalnız bir defa, yalnız bir kez, bir öğün
eşidüt: işitme
igdüle-: beslemek, özen vermek, özenmek, itina ve dikkat etmek, ilgilenmek, uzatmak
itdür-: ettirmek, tertip ve tanzim etmek, düzenlemek
kendü: bkŋz; kentü
Kimetdü: kişi adı
ködüg: iş güç, alışveriş, ticaret
ködür-: bkŋz; kötürmek
köydür-: yakmak
kündüri: güneyde
kündüz: gündüz, gündüzün
kürdüş: manası anlaşılmıyor
küsedük: istek
küydür-: yaktırmak
küzetdür-: yerine getirmek
öndür-: büyütmek, düzene koymak, tanzim etmek, alacakları toplamak
öŋetdür-: iyileşmek, şifa bulmak, onmak, iyi etmek, değişmek
öŋdün: önden, önde
öŋdürti: önden, karşı yakadan
ördün-: bkŋz; örtünmek
Semdükü: yer adı
utlılığ: müteşekkir, teşekkür, borçlusu, medyun
niluptal: Nymphea stellata
tŋrim: tanrım, haşmetmeab, ilahım
enkebüş: çivit
il ebi: hükümet konağı
İlteber: hükümdara bağlı yüksek devlet memuru rütbesi
sebin-: bkŋz; sevinmek
tebe: bkŋz; teve
tebiz: kurak yer, otlakiye, çimenlik
meŋle-: ebedileşmek, ölmezleşmek, bengüleşmek
alpırka-: kendisine yiğit süsü vermek, sebatla çalışmak
anın: ondan dolayı, bunun için, bu sebeple, onunla
evinlig: gebe, hamile
antağ: bkŋz; antak (anta+ok), böylece, böyle, bu suretle
ige: bkŋz; idi, bey, sahip, peri ruh (mecaz)
irgür-: tamamlamak, becermek, başarmak
ir-tal: harf (hece) adıdır
ir-tsi: harf (hece) adıdır
ir-ur-ui: harf (hece) adıdır
ir-vaŋ: harf (hece) adıdır
isak: harf (hece) adıdır
keligme: gelecek olan, gelen
kin: sonra, son, misk, kokusu, iyi bir koku, Çince 'ipekli kumaş', istikbal, gelecek
kininte: istikbalde, gelecekte
kök: mavi, gök rengi, sema, gök, gece
körünç: piyes, görülecek olan şey, görünüş, manzara
mayak: (Sanskritçe mayika), pislik, necaset
muna: işte, bak, böylece
munça: böylece, bunca, bu suretle, bu kadar
bitkeçi: bkŋz; bitigüçi
erkeç: genç teke
İneçi: kişi adı
küteçi: güden, saklayan, koruyan
öpkeçi: öfkeçi
övkeçi: öfkeyi kabartan kimse, öfkelendiren, kızdıran, kışkırtıcı
Kır Çeçek: kişi adı
seçil-: seçilmek
seç-: seçmek
emged-: bkŋz; emgetmek
işled-: bkŋz; işletmek
bosan-: kederlenmek, müteessir olmak
sap-: devam eetmek
suklan-: teessüs etmek, ihtiraslanmak
türçi-: türemek, kurulmak, teessüs etmek
başladaçı: şef, amir, baş, başkan
başlataçı: baş olan, amir, şef, baş, başkan
bir tek: bir kez, bir defa, bir yol
bir hata: bir kez, bir defa
boz: tiksinti, nefret, kin
er: erkek, kimse, efendi, bey, şehzade, zevc, koca
ikile: iki kez, iki defa, tekrar, yeniden
ilçi: elçi, sefir
irinç yarlığ: sefil hayatlı
kekre-: nefret etmek, tiksinmek, düşmanlık etmek
kekreş-: nefret etmek, tiksinmek
egsük: eksik, eksiklik
egsüksüz: eksiksiz
egsü-: eğsilmek, azalmak
aŋıt-: eğilmek, saygı duruşunda bulunmak
birük: eğer, fakat
birükin: eğer, şayet, fakat
birükiye: eğer, şayet, fakat
emit-: eğilmek, eğmek
eŋgil-: eğilmek
eŋir-: eğirmek, takip etmek, çevirmek
eŋit-: eğdirtmek
iŋle-: eğilmek
meŋilet-: eğlendirmek
kamıt-: eğmek
sıkan-: eğmek
yügün-: eğilmek, bkŋz; yükünmek
ağu: ağı, zehir
ağuluğ: ağılı, zehirli
ağu-: ağılamak, zehirlemek
ağuk-: ağılanmak, zehirlenmek
alp yol: tehlikeli, çetin yol
balık: bkŋz; balığ, balık, şehir
balıklığ: şehirli
Banaras: Benares şehri
Baranas: Benares şehri
Barshan: şehir adı
Erzi: bir şehzadenin adıdır
ilig beg: şehzade, kral
ilt-: iletmek, sevketmek, kılavuzluk, rehberlik etmek
Kenç Teŋrim: prenses, şehzade hanım lakabı
kenç Tuğmış: şehzade oğlu
Seil: özel ad
yörgei: bir çeşit bitki
kuu: (Çince wei), tehlike, bkŋz; alp
tutukluğ: başbuğlu, reisli
eki: bkŋz; iki
ekin: ekin
ekirt-: bağırtmak
ek-: ekmek
eksid-: eksiltmek, azaltmak
eksük: eksik
eksüklüg: eksiklik
eksüksüz: eksiksiz, noksansız
eksü-: eksilmek, azalmak
eksüt-: eksiltmek, azaltmak
ekşobi: bkŋz; akşobi
ekün: çift, iki
aŋrek: tırnak, bkŋz; erŋek, bkŋz; eŋrek
el: bkŋz; il
elçi: bkŋz; ilçi, kişi adı, özel ad
elge-: bir şeyin arasına bir şey sokmak, sıkıştırmak
Elgür: kişi adı
elig: elli, el
eligçi er: memur
elit-: getirmek, iletmek
el-: yaklaşmak, iletmek
elp: bkŋz; alp
ėl: halk
beliŋ: korku
beliŋle-: korkmak, ürkmek, korkudan titremek
beliŋlet-: korkurmak
beltir: yol kavşağı, yol ağzı
bertel-: bkŋz; birtelemek, yaralamak, tarihbetmek, yıkmak
erpelmek: törpülenmiş, biçilmiş, kesilmiş
ilçi bilgeler: diplomatlar
inç kel-: yavaşcacık gelmek
İŋel: kişi adı
kelen: gergedan
kelem: (Sanskritçe kalama), kalem
kelig: hayal, görünme, ortaya çıkma, geliş
kelim: bkŋz; kelem, kalem
em: ilaç, tedavi vasıtası
emçin: bkŋz; emçi
emdi: bkŋz; amtı, bkŋz; emti
emeri: bkŋz; amarı
emgen-: izdırap çekmek, ah çekmek
emget-: eziyet etmek, tazip etmek
emgetmeksiz: eziyet vermeksizin, eziyetsiz
emırtğur-: bkŋz; amırtğurmak, teskin etmek
emig: meme
emiz-: emzirmek
emkek: bkŋz; emgek
emle-: tedavi etmek
emrak: bkŋz; amrak
emraklığ: bkŋz; amraklığ
emrü: bkŋz; amru
emsi-: emmek
emsiz: emsiz, ilaçsız
emti: bkŋz; amtı
Basa Temir: erkek adı, kişi adı
Bay temür: erkek adı
birtem: birden, tamamıyla, büsbütün, toptan
Buyan Temür: kişi adı
enetkek: hint, hindistan, hintli
eŋ: av, en
eŋek: çene kemiği, çene
eŋim: kısım, parça, ayrım
eŋin: bkŋz; egin, omuz
eŋ-: iğmek
eŋrek: bkŋz; erŋek
Eŋürün İlçi: kişi adı
entkek: bkŋz; enetkek
enük/g: hayvan yavrusu, kişi adı
enükle-: yavrulamak [hayvan için]
arvık tenri: tanrılardan birinin adıdır
Bergin Seŋe: kişi adı
birlen: ile, beraber, birlikte
eren: yiğit, asil kimse, kahraman, asaletli er, eren, erkek
Eren: kişi adı
tivadar: (Sanskritçe devadāru), deodar ağacı
irbiş: kar leoparı
sepen: anlamı bilinmiyor
tep: tekit yerine kullanılır
Tepiş: kişi adı
tepit-: ezdirtmek, parçalatmak
tepiz: bkŋz; tebiz
tepizlig: çok sürülmüş, ezilmiş, işlenmiş, tepilmiş arazi
tep-: tepmek, vurmak, çifte atmak
tepter: defter
alku: hepsi, bütün, hep, herkes, her nevi, çeşitli
alkuğun: büsbütün, hep, bütünü ile
alkunı: hepsi, bkŋz; alğunı
barça: hepsi, tamam
bay-: kelepçelemek, bağlamak, bendetmek
birgerü: hepsi bir arada, tümü ile
kaban: tabak, tepsi
kamağ: hepsi, bütün, topyekün
kamağan: bütün, hepsi, baştan başa
kamağlarını: hepsini
er at: topluluk, sürü [insan], kalabalık
Erem: kişi adı
Erem Kara: kişi adı
erbiş bitig: sözleşmeyi andıran belge
erdinliğ: değerli, kıtmetli, cevahirle süslü, cevherli, murassa
ergülük: ikametgaha ait olan, evli, haneli, evle ilgili
ergür-: eritmek
ergüs-: eritmek, bkŋz; ergürmek, bkŋz; ergüzmek
erig: öğüt, nasihat
erigle-: öğüt ve nasihat vermek, öğütlemek
eril-: bkŋz; evrilmek
erin: dudak
erinç: ermek'ten şüphesiz, kesin olarak, tamamıyla
erin-: erinmek, üşenmek, tembelleşmek
eriş: bkŋz; evriş, bkŋz; bkŋz; erviş
erivadi: (Sanskritçe revatī), bir yıldızın adıdır
erk: erk, kuvvet, kudret, güç
Erk Arslan: kişi adı
erkek: erkek
erki: ermek'ten '-dır, -tır', iyi, artık, belki
Erklig Kan: kişi adı
erkligin erksizin: ister istemez
erksin-: kudretlenmek, güçlenmek
erksintür-: hakimiyet sürdürmek, egemenliğini yürütmek
esen: esen, sağ, salim, sıhhatlı, sulh, barış
Esen Buğa: kişi adı
esengü: sağlık, sıhhat, kamilen
esengü bitig: sıhhat mektubu, sağlık belgesi senedi
esengüle-: sıhhat, dilemek, durumdan haberdar olmak, hatır sormak
esengülük: esenlik, sağlık, selametlik, rahatlık
esiç: tencere, kazan
esin: yel, rüzgar
esirge-: esirgemek
esir-: bkŋz; esürmek
eski: eski
eski-: eskimek
eskir-: eskimek
esri: bir hastalıktır
esriŋgü: renkli, alaca bulaca, alaca
esrük: serhoş
este-: bkŋz; istemek
estup: bkŋz; stup
esür-: sarhoş olmak
besgek: bkŋz; bezgek
İl Ügesi Ata: kişi adı
il ügesi: retbedir
işlemesik: işlenmesi yasak olan iş
kenç Estemi: kişi adı
kesk: ilaç adı
kesil-: kesilmek
kesiş-: kesişmek, uyuşmak, bir sonuca varmak
keskile-: ufalamak, küçük parçalara bölmek
kesme: kıyma, yemek
kes-: kesmek, kırmak, tayin etmek, koymak
kesmelig: kesilmiş, kesmeli
övkesiz: öfkesiz
Kada Esrük: kişi adı
sözlemesik: söylenen çirkin sözler, laflar
eş: eş, arkadaş, dost
eşek: bkŋz; eşkek
eşi: bkŋz; işi
eşiç: bkŋz; işiç
eşid-: işitmek
eşidil-: işitilmek
eşitmeklig: eşitmeklik, eşitmeli
eşittür-: eşittirmek
eşkek: eşek
Eş Kara: kişi adı
eşriŋgü: iyi kokulu (?)
eştil-: eşitilmek
eşük: örtü
beşek: haremlik
irpekleş-: biçişmek, kesişmek
keŋeş: müzakere, müşavere, kenkeş, danışık
keŋeş-: müzakere etmek, müşavere etmek
kenkeş-: müzakere etmek, müşavere etmek
kiŋeş-: istişare, müşavere etmek
kiŋeşin-: müşavere, istişare etmek, danışmak, danışık etmek, kenkeşmek
kirleş-: kirlenmek, pislenmek
ökleş-: vuruşmak
sözleş-: konuşmak, sözleşmek
teŋkeş-: mukayese etmek, karşılaştırmak
tikileş-: fasıldaşmak
yöleş-: benzemek
yöleştrüg: eşit, müsavi
yöleştür-: eşit kılmak, müsavi kılmak
et: et
etçi: kasap
etig: süs, bezek, tazyinat
etik-: meydana getirilmek, gerçekleştirmek
etil-: edilmek
etin: kükreme, ses
etine-: kükremek
etinlig: kükreyen, çınlayan, süslü
etin-: süslemek
etiz-: çınlamak
etlig: etli
etlik: mezbaha, et kesilen yer, salhane, kandra
etle-: yapmak, etmek, eylemek
et-: etmek, eylemek
et'öz: bkŋz; et'üz
etük: edik, terlik, ayakkabı, çizme
betiset-: bkŋz; bedizetmek
betük: bedük
betü-: büyümek
irklet-: zorlamak, elde etmek
istet-: istetmek
işlet-: işletmek
ev: ev, çadır
evçi: kadın
evin: tane, adet, yemiş, bububat tanesi, tohum
evir: daire, çevre, muhit
evrik/g: kaba, sarsak, aptal, ters
evriş-: bir işle meşgul olmak
evür-: evirmek, işlemek, çevirmek
kevil-: zayıflatılmak
sevgülüg: sevgili, sevimli, sevgi
sevgüsüz: sevgisiz
sevig/üg: sevgili, sevimli, aziz, aşk
seviglig: sevimli, sevgili
Sevik: kişi adı
sevinç: neşe, sevinç
sevinçeŋ: neşeli
sevin-: sevinmek
sevintür-: sevindirmek
sevit-: sevdirmek, sevilmiş olmak, sevilmek
sev-: sevmek
sevüg: sevgi, sevgili
sevüglüg: bkŋz; seviglig
tev: fesat, hile, kandırma
teve: deve
tevle-: aldatmak, tavlamak
tevlig: hileli, hilekar, aldatıcı, yalancı
tevlüg: bkŋz; tevlig
tev-: dizmek
tevsiz: hilesiz, fesatsız
ey: nida 'ey'
eymenç: utanç, korku
eymen-: utanmak, hicap duymak
İrkey: kişi adı
Kerey: kişi adı
keyik: geyik, vahşi hayvan
keyikçi: avcı, geyik avcısı
keyirgençik: karışıklık, isyan, kargaşalık
key-: giymek
Keyre: yer adı
Keyre Başı: yer adı
Küldirtey: kişi adı
tegirmileyü: çepçevre
tikileyü: tekrar, ikinci defa
tükemeyük: tükenmemiş
teylim: garanti
ezük: yalan, sahte
ezükle-: yalan söylemek, aldatmak, hata etmek
ezüksüz: yalansız, hatasız, kusursuz, yanlışsız
bezeklik: süslenme yeri
beze-: süslemek, bezemek
bezgek: soğuk sıtma, sıtma
bez-: titremek
keze: yavaş yavaş, sıra ile
kezek: bkŋz; kesek
kezig: tertipli, düzenli, sıra, muntazam, sıralı, sıtma
keziklig: sırası gelmiş olan, nöbette olan
kez-: gezmek, dolaşmak
körmez: kör
kövez: burnu havada, mağrur
kübez: bkŋz; Grur
Seŋetez: kişi adı
tezik/g: sıra
tezgin-: bkŋz; tegzinmek
tezkin: kaçak, firari
tez-: kaçmak, firar etmek
tezük/g: bkŋz; tezik/g
Yezir Toŋa: kişi adı
tirezüg: terâzi
basur-: ezmek, basmak, atmak
tusu: fayda, semere, kazanç, (Moğolca tusa), bkŋz; tuzu
tusul-: faydalanmak
tusuluğ: faydalı
ürlüksüz: fani, geçici, ölümlü
basa basa: bir taviye, durmadan, fazlasıyla, kesilmeden
törüçe: örfçe, törece
tıkıl-: felakete uğramak, kaygulanmak
uluğ puşuş: felaket
üzlünçüg: fevkalade, üstün, olağanüstü
yavız: fena, kötü, bkŋz; yavaz ~ yabız
yavlak: fena, kötü, yavuz, düşmanca
anığ: kötü, fena
artukta artuk: pek iyi, fevkalade
boş bir-: yardım etmek, iane vermek, feda vermek
yel: pis koku, taaffün, çürüklük
yıdığ: pis kokan, kokmuş, taaffün etmiş, bkŋz; yıtık
uğur: fırsat, tesadüf
kemiş-: atmak, fırlatmak, bırakmak, düşürmek
közetçi: muhafız, gözetçi
küzetçi: gözetiçi, muhafız
kamıl-: devrilmek, yere yuvarlanmak, sallanmak, fırlatılmak
kşatrik: (Sanskritçe ksatriya), asker sınıfına mensup olanlar
sud-: atmak, fırlatmak, akmak
taşıl-: taşmak, dışarı fırlamış olmak, bkŋz; tasılmak
tegirmile-: yuvarlaklaştırmak, etrafını çevrelemek
tolı: tam, dolu, bir şeyin çevresi, etrafı
yığ: çığ (?), fırsat, vesile
yaŋa: fil
berişti: melek, firişte
köŋül: gönül, kalp, fikir, istek, tefekkür, arzu, ülkü
kalanlığ: kalan vergisi mükellefi
kavrığ: ağrı, nöbet, tevfik, tutku, tutma
konuk: misafir, konuk, konulan yer
konukluk: misafirlik, konukluk, menzil, konak
sün-: gevşemek, hafiflemek
öpke: bkŋz; övke, öfke, ciğer
övkelen-: kızmak, öfkelenmek
tarın-: hırslanmak, öfkelenmek, kızmak, hiddetlenmek
tarıkınç: sıkılma, rahatsızlanma, öfke
yarlıka-: buyurmak, vaaz vermek, öğüt vermek, haşmetle yapmak, iltifat etmek, şefkat göstermek
yarlıkan-: zırhlanmak, zırh giymek, şefkat etmek, yardımcı olmak
yas: zarar, ziyan, halim, şefkatli, bkŋz; yaz, bkŋz; yaş
yiri-: kızmak, öfkelenmek, tekdir etmek, parçalanmak, yarılmak
alŋad-: zayıflamak, arıklamak, halsiz olmak
bitig: yazı, kitap, belge, vesika, vesiyetname, hurufat, harfler, alfabe
meŋi: neşe, sevinç, sevinme, sürur, keyiflenme, ebedi, bengü, ölmez
ös-: üflemek, şişirmek, kabartmak
koğşa-: gevşemek, zayıflamak
tuğsa-: zayıflamak
uyırkan-: kuvvetten düşmek, zayıflamak, yorulmak, donakalmak
ür-: kabartmak, üfürüp şişmek, üflemek, havlamak, sürmek (ilaç)
yaratu: tarafların rızası üzerine (hukuk)
yokurkan-: kuvvetten düşmek, zayıflamak
nom: âriflik, doktrin, öğreti, disiplin
karğa-: kargamak, beddua etmek, küfretmek
kora-: çıkarmak, kaldırmak (safra hakkında), kaybetmek, ziyan etmek, azalmak
sarğ: safra
üz: nefret, kin
yarsığu: istikrah, nefret, tiskinti, tiskinme
yarsı-: istikrah etmek, tiksinmek, nefret etmek
yırınçık: tiksinti veren, menfur, nefret edilen
kiŋürt-: genişletmek, tefsir etmek
yaŋra-: ifşa etmek, açığa vurmak, ihanet etmek
çası: leke sürme, çamur atma, iftira
çasur-: leke sürmek, çamur atmak, iftira atmak
çasut: iftira, leke
nızvanı: ihtiras, aşırı düşkünlük, iptila, meftunluk
koptın: her yerden, her taraftan
koş: çift
tülüg: şeftali, baharat
vusanti: haftalık dini dua oturumu
yala: şüphe, kuşku, bühtan, iftira
yoŋağ: iftira, bühtan, yalan yere suçlama
yoŋa-: iftira etmek, itham etmek, yalan yere suçlamak
ötgür-: açıklamak, hulul etmek, girmek, yola vurmak, uğurlamak, nüfuz etmek
tsuen-ni: Konfutçiyus'un adı
vu: tılsım, (Çince fu)
yarınçık: kötü, menfur
yarsığak: menfur, çirkin, iğrenç
yarsınçığ (k): menfur, tiksindirici, murdar, mekruh
sögüş: küfür, söğüş
sögüş-: küfürleşmek, karşılıklı söğüşmek
söküş: söğüş, sövme, küfür, sögüş
ürül-: şişirilmek, üfürülüp şişirilmek, gerilmek
Yoga: bkŋz; Yog
Yogalun: (Çince Yü-kia lun), Şastra adı
uygat-: uyandır-
karıp: garip
tumsuğ: gaga, bkŋz; tumşık
tumşık: gaga, bkŋz; tumsuğ
tumşuk: gaga
tumşukluğ: gagalı, gagası olan
usal: gamsız, kedersiz, keyli
ötegçi: bkŋz; ötekçi
ötügçi: ricacı, dilekçi, rica eden
titigçi: alçıcı, duvarcı
ötegçi bitig: borç senedi
igdile: ilaç karşılığı olarak kullanılan bir şey
igdilen-: iyice beslenilmek, özen görmek
yigde: Zizyphus vulgaris bitkisi
igtüle-: bkŋz; igdülemek
kağda: bkŋz; kegde
berge: kamçı, kırbaç
birge: bkŋz; berge
birger-: çalkalamak
ig kigen: bir hastalık
ilgerü: ileri, ileriye doğru, ileride
İl tirgek: kişi adı
kuŋkan: çalgı, musiki aleti, harfe, (Çince k'önghevu)
Yztigırd: kral adı
aruk: yorgunluk, argınlık
başlağ: başlangıç
buusı: dağınık, dalgın
ilki: ilk olan, başlangıç, baş
kigen: hastalık, salgın
kögüzlüg: düşünceli, dalgın
oyuğ: oyun, çalgı çalma, raks, müzik
öŋüç: boğaz, gırtlak
kadır: sert, somurtkan, yırtıcı, kızgın, hiddetli
karlığaç: kırlangıç
kıvad-: kutlamak, hürmet etmek, saymak, saygı göstermek
birgin: ödeme
bir yigirmi: onbir
igid: yiğit, delikanlı, yalancı, hilekar, yanlış
igid nom: uydurma kanun
igid-: yetiştirmek, beslemek, özen vermek, bakmak, itina göstermek
igil: yavuklu, nişanlı, adaklı, bayağı, dünya ile ilgili
igit: yalan, hile, dalavera
igitil-: beslenilmek, bakılmak
İl Aşmış Tigin: kişi adı
İl İtmiş Tigin: kişi adı
il örgin: saray
işgiti: bkŋz; işgirti
işgirti: bkŋz; işkirti, diba denilen ipek kumaş
kiginç: karşılık, cevap
kiçigkiye: ufacık
şişaki: (Sanskritçe sasāngka)
igle-: hastalanmak, hasta olmak, sayrulanmak
iglig: sayru, hasta, hastalıklı
isig isiglig: sıtma
isiglig: ısılı, sıtmalı, hararetli
körgle: güzel
körglüg: görünen, güzel, manzaralı
örtüglüg: örtülmüş, gizli, saklı
ötegle-: bir iş yapmak, iha etmek
söglün-: kızartılmak
söglünçü: kızartma
süglün: sülün
sviglig: bkŋz; seviglig
teglüg/k: kör
tütsüglük: buhurdan
yörüglüg: izahlı, şerhli
imerigme: çevrilmiş, kuşatılmış, sarılmış olmak
Kögmen: yer adı
ök-: bkŋz; ögmek
tek-: tegmek
tügne-: yanmak
yigne: iğne
muŋa: buna, mungo
usır: bir bitki adı, andropogon muricatus, (Sanskritçe usıra)
kindik: göbek
köç: göç
kögüs/z: göğüs, kalp
köl: göl
kölige: gölge
köligelik: gölgelik
kölit-: gölgelemek, gölge etmek
kölü-: gölgelemek
kö-: gömmek
kömül-: gömülmek
kön: gön, deri
körgür-: göstermek
körket-: göstermek
körkit-: göstermek
kör-: görmek
körkmeklig: görme
körkür-: göstermek
körküt-: göstermek
körtgür-: göstermek
körügse-: görmek istemek, görmek isteğinde bulunmak
körül-: görülmek, sanılmak
körün-: görünmek, gözükmek
körüş-: görüşmek
kötrül-: götürülmek, kaldırılmak, yükseltilmek
kötür-: götürmek, yüklemek, kaldırmak
kötürül-: götürülmek
köz: göz
közet-: gözetmek, saklamak, muhafaza etmek
közsüz: gözsüz, kör
nirgrantha: bir yere yerleştiren ve yerleştirilen, iskan eden ve olunan
ögretin-: talim görmek, öğrenmek
ögret-: talim ettirmek, öğretmek
ögrünç: sevinç, sürur, ökrünç, kişi adı
Ögrünçe: özel ad
ögrünçüle-: tenezzühe çıkmak, eğlence tertiplemek, sevinmek, gezmeye çıkmak
ögrünçülen-: sevinmek
ögrünçülüg: bkŋz; ögrünçlüg
ögrünçü: sevinçli, memnun
ögrünçüligin: sevinçle, memnuniyetle, sevine sevine
tegreki: çevredeki
Tegrenç: kişi adı
ygrmi: yigirmi
yigrek: daha iyi
yügrük: bkŋz; yügürük, yügrük at 'süratle koşan at'
tekre: bkŋz; tegre
tekreki: bkŋz; tegreki
tikre: bkŋz; tegre, bkŋz; tekre
igsiz: sağlam, hastalıksız
işidigse-: işitmek istemek
itigsiz: hareketsiz, işsiz
ögsire-: aklını kaybetmek, zekasını kaybetmek
ögsük: manası anlaşılmıyor, sönük olabilir
ögsüz: öksüz, annesiz, akılsız, zekasız
öpögse-: öpmek istemek
örtüntegsiz: ilaçsız, emsiz
üzügsüz: durmadan, daima, kopmadan, fasılasız, aralıksız, bkŋz; üzüksüz
körökse-: bkŋz; körügsemek
üzüksüz: bkŋz; üzügsüz
tegşil-: değişilmek
tegşül-: değiştirmek
tegşür-: ulaştırmak, getirmek, eriştirmek, sevketmek
tegşürüş-: değiştirilmek
ugşürü: tekerrür eden, tekrarlanan, bkŋz; ögşürü
tekşür-: bkŋz; tegşürmek
Burguçan: kişi adı
purva pulgunu: bir yıldız adı
soorgun: (?)
utrapalguni: (Sanskritçe uttaraphalguni), yıldız adı
bolgu: imkan, olanak
bolguluk: imkan, olanak
küvenç: gurur, güvenç, kendini beğenme
bosantur-: kederlendirmek, üzülmek, kaygulanmak, üzmek
bosuş: kaygu, keder, gam
bosuşluğ: kaygulu, kederli, üzüntülü
boşurkan-: rahatsızlık hissetmek, kendisni kusurlu, rahatsız saymak, kaygulanmak
busuş: dert, keder, kaygu
busuşluğ: kederli, dertli, kaygulu
kögenç: ululanma, büyüklenme, gurur, güvenç, kibir, azamet
muŋ: keder, endişe, kaygu
muŋsuz: dertsiz, kedersiz, kaygusuz
nomluğ: kanuni, kanuna uygun
bergü: kamçı
bergür-: bkŋz; belgürmek
birgü: bkŋz; bigü
ermegür-: erinmek, tembelleşmek, ihmal etmek
tegzinç: tomar, fasıl, başlık, daire, muhit, devir, dalga, girdap
teksinç: bkŋz; tegzinç
teksin-: bkŋz; tegzinmek
Bay Buğa: erkek adı
bosğak: bkŋz; bozğak
bozğak: bozulmuş, bozulma
balığçı: bkŋz; balıkçı
satığçı: satıcı
tapağçı: hademe, tapan
tapığçı: hizmetçi, hademe
tarığçı: köklü, ekinci
yuluğçı: satın alan, vergiye tabi olan
borçı: bağçivan, üzüm vergisini toplayan memur
borlukçı: bağçivan
Noğdar: kişi adı
ankıttır-: baş eğdirmek
közünür: çağdaş, muasır, halihazırdaki
kurat-: toplamak, yığdırmak
sığur-: sığdırmak, bkŋz; sıkurmak
tegürt-: değdirmek, değirmek, eriştirmek
arsu: değersiz, kıymetsiz
birök: bkŋz; birük, eğer, şayet
kim: ki, kim, kimler, kimse (olumsuz), ola ki, eğer, şayet
köntül-: dürüst idare edilmek, gerçeğe sevketmek, doğrultmak
nirvana: (Sanskritçe nervān), nirvana, değersiz bir sükünet
ötle-: nasihat etmek, öğüt vermek, iyiliğe teşviketmek
ötün-: nedamet etmek, pişman etmek, ricada bulunmak, dilemek, küçüğün büyüğe hitabı
tetrül-: aldanmak, aldatılmak, baştan çıkarılmak, iğfal edilmek
yalkantur-: aldatmak, iğfal etmek
horğınç: bkŋz; korkunç, korkunç
alpağut: bir rütbe, alplar, yiğitler
bursoŋ: bkŋz; bursaŋ, rahipler derneği
hualığ: hua çiçeği ile süslenmiş, çiçekli
it burnu: yabani gül meyvesi, çiçeği
kelkin: su hendeği (?)
yarlığka-: bkŋz; yarlıkamak, haşmetle yapmak
batığlık: tuvalet, apteshane
kenç oğlan: genç
ornağlığ: sağlam, muhkem
kamağlık: umumi olarak
Kan-oğlu: kişi adı
katağlan-: bkŋz; katıklanmak
katağlığ: pek, katı
katığlantur-: teşvik ve takviye etmek, yeltenmek, düşünmek, cehdettirmek
koğla-: bkŋz; kovlamak
kutğurmağlağ: kurtulmaklık
Barça Toğmış: erkek adı
İl Yığmış Teŋrim: kişi adı
Kenç Toğmış Tarhan: Tarhan lakabı
Kin-Toğmış: kişi adı
Kara Toğma: kişi adı
tanığma: danma, inkar
Toğma: kişi adı
toğmış: akraba
toğmışım: akrabam, uruğum
ankıt-: baş eğmek, teslim olmak
idi-: toplamak, derlemek, yığmak, biraraya getirmek, elde etmek
inçip: lakin, fakat, .....rağmen, sonra
iti-: yığmak, toplamak
kadır-: bükmek, eğmek
sığ-: hoşa gitmek, uymak, sığmak
sid-: işemek, siğmek
tala-: yağma ve talan etmek
talım: hırsız, yırtıcı, yağma, cenk
talı-: talan etmek, yağmalamak
tal-: dalmak, zekası kararmak, talan ve yağma etmek
tegiş: değme, temas, dokunma
tok-: bkŋz; toğmak
törçi-: türemek, doğmak, neşet etmek
irit-: kötüleşmek, kötü olmak, iğnelendirmek
kaŋlı: kağnı, araba
kaŋlıçı: arabacı, kağnıcı
turuğ: durak, otlak, sığnak, melce, saf, temiz, duru, berrak
moğoç: bkŋz; moğuç
nğoşak: Samiin (mani mezhebince)
niğoşak: Samiin, mani dinine mensup olanlar
toğot: bkŋz; toğut
niğusek: bkŋz; niğoşak
oruŋ: bayrak, (Moğolca oruŋğa)
şire: masa, (Moğolca şirege)
turkaru: hep, durmadan, (Moğolca torkaru)
artuğrağ: bkŋz; artukrak
ig ağrığ: hastalık
nğran: bkŋz; nağran
Kotan Toğrı: erkek adı
tığrak: sağlam, pek
toğrı: bkŋz; toğru
Toğrıl: erkek adı
Toğrul: kişi adı ve lakap
uğra-: planlamak, niyetlenmek, arzulamak
Yap Toğrıl: erkek adı
yuğrul-: karışmak
barığsa-: gitmek istemek
basığsız: minnetsiz
okşatığsız: benzeri olmayan
ornağsız: sağlam olmayan, daimi olmayan
kavrığsız: müstakil, bağımsız, özgür, özgürsüz
kısığsız: kısıksız, dertsiz, hür
kuruğsak: kursak, karın
sanağuluğsuz: sayısız, hesapsız, sayılamıyacak kadar çok
tapığsak: hizmetkar, hitmete hazır, hürmetkar
tıdığsız: yasaksız, maniasız, engelsiz
tıltağsız: sebepsiz
tıtığsız: bkŋz; tıdığsız
tuyuğsuz: duygusuz, görgüsüz
umuğsuz: dayanıksız, sığınaksız, melcesiz
yarağsız: yakışıksız, hoş, olmayan
yoğsuz: nafile, lüzumsuz, boşuboşuna
koğşak: gevşek
ukuş: benzeyiş, soysop, kabile, soy, bkŋz; uğşatı
ağtın-: çıkmak, binmek, ata binmek
sığta-: ağlamak, sızlamak
sığtaş-: ağlaşmak
Altun aruğu: bir boyun adı, bir halkın adı
Aruğu: bkŋz; Arğu
basğuk: yekpare, som, yoğunluk, dağ parçası, kaya
başağut: sevilen, hoş görülen
bayağut: varlıklı, zengin
imirt söğüt: bir ağaç türü
hoyın: koyun (göğüs), on ikili hayvan takviminde bir yılın adıdır, koyun
kökre-: kükremek, bağırmak, böğürmek
möŋre-: böğürmek, çağırmak
müŋre-: bkŋz; möŋremek, böğürme, bağırma (hayvan içim)
nomlal-: kutlanmak, va'zedilmiş olmak, öğüt verilmiş olmak, takdis edilmek
öt: nasihat, öğüt, öd
kızaşı: düğün, toy, düğün ziyafeti, düğün şöleni
salsöyüt: söğütün bir türü
sars-: söğüp saymak
tal: dal, dalak, (Sanskritçe tāla) büyük bir ağaç, söğüt ağacı
toi: şehir, karargah, bkŋz; toy, eğlence, ziyafet, ziyafet, düğün
tügün: düğüm
üt: delik, deşik, geçit, zaman, vakit, öğüt, nasihat, ahkam
yıvıl-: methedilmiş olmak, öğülmek, övülmüş kimse
yögür-: yüğürmek, akmak
iş: eş, dost, ahbap, iş
yerçile-: rehberlik etmek, kılavuzluk etmek, sevketmek
yirçi: rehber, kılavuz, yol gösteren, bkŋz; yirtçi
yirtçi: kılavuz, rehber, yol gösteren, bkŋz; yirçi
yolçı: yolcu, kılavuz, rehber
yorçı: kılavuz, rehber, yol gösterici
uyat-: utanmak, mahcup olmak
yimişlik: bahçe, ağaçlık
katığ: katı, sağlam, cehd, pislik (?), karışık, katışık, karma
titin-: atılmak, cehdetmek, didinmek
yan-: tehdit etmek, dönmek, geri dönmek, yaymak
baştankıta baştankı: herşeyden önce
bat: hemen, derhal
kün küniŋe: hergün
künikeki: hergün, daima
küninte: hergün, devamlı, sürekli
küntemek: hergün
nerse: her ne olsa
ökrem: hendek
kamağu: hep birlikte, bkŋz; kamığu
kamağun: hep
karam: hendek
kopan: hep
sayu: herbiri, herkes
tire: hep birden, beraber, müştereken
tözü: hepsi, tekmili, tamamı
trkin: hemen, derhal, hemence
utğurak: hep, tamamıyla, kesin olarak, kat'i, bkŋz; utğurağ
kemsiz: sağlam, hastalıksız, sıhhatlı
toğasız: hastalıksız, sıhhatli
yaratığlığ: mücehhez, donatılmış
hıvlığ: kutlu
hıv: bkŋz; kıv
hız: bkŋz; kız
ohı-: bkŋz; okımak
tohı-: vurmak, bkŋz; tokımak
yılhı: bkŋz; yılkı ~ yıllık
hundaçı: hırsız
kundaçı: hırsız
sıkta-: hıçkırarak ağlamak, hıçkırmak, feryad etmek
tiklilig: hızlı, yüksekten, ses çıkararak, gürültülü patırtılı
İnançu: şahıs adı, memuriyet ünvanı
kağadaş: akraba, hısım
Kavişki: İndras ilahının lakabıdır
kun-: çalmak, hırsızlamak, uğrulamak
sığıt: ağlama, hıçkırk, matem, feryad
tos-: inatçılık, geçimsizlik, hırçınlık etmek
tüŋür: sıhıyet, evlenme yolu ile akrabalık, dünür, şaman davulu
purohit: ev sahibi
altağ/k: hile, ali, aldatma, yardım, destek
iştrüş-: hikaye söylemek, karşılıklı hikaye anlatmak
kür: hile, fesat, alda, al, kandırma
kürlüg: hileli, yalan, aldatıcı, aldatan
kürsüz: hilesiz, yalansız
Matyadiş: hindistanda bir devlet adı
punya: hizmet
Kanişki: hint imparatorlarından birinin adıdır
kulluğ: hizmetçi, esir sahibi
Sındu: Hindistan
tömke: hile, büyü
tömkesiz: hilsesiz, büyüksüz
yumuş: hizmet, iş, faaliyet
yumuşçı: hizmetçi
kiter-: gidermek, uzaklaştırmak, alıp götürmek, tahkir etmek
ölümçi: ölüme mahkum
karım: çukur, yalak, su hendeği, müstahkem yer
kıvırkak: tamahkar, hasis, eli sıkı
tsuyluğ: suçlu, kabahatli, günahkar
yarpsız: kuvvetsiz, güçsüz, istihkamsız
yazukluğ: kusurlu, günahkar, suçlu
kişi: kişi, insan, adam, mahluk, yaratık, zevce, eş, kadın, kul, köle, prenses
ovutluğ: haya, utlu, utangaç, hayalı, ahlaklı
kara: kara, bkŋz; budun, halk, millet, yılkı kara, hayvan sürüsü, ehli hayvan
kılık: karakter, huy, ahlak, yaradılış
tökük: Libation, ilahların şerefine yere içki dökme
tuda: tehlike
tudasız: tehlikesiz, bkŋz; tuddasız
üzütlüg: ruh, cana ait, ruhla, canla ilgili
kem: ağrı, zahmet, hastalık, ıztırap, kem, eksik, noksan
kıntur-: bir şey için zahmete katlanmak
sımtağ: derbeder, avare, aylak, orman, ihmalci, savsakçı
krmşuhn: suçundan geçme, bağışlama
kındur-: mihnet çekmek, bir şeyden muztarip olmak, iştiyak etmek
hobuz: bkŋz; kobuz
hol: kol, el
hol-: kolmak, istemek, arzulamak
Honuğ: özel ad
hok: bkŋz; kok
Hormuzda: Indra ilahisinin adıdır, ilk insan
Horuğ: ilah adı
yak-: hoşa gitmek, yakışmak, yaklaşmak, yakmak, sürmek
birtiş-: birbirini cezalandırmak, hor görmek, talıkir etmek
burun: burun, hortum [hayvan için], önce, önceler, evvel, evvelleri
hurmuzta: bkŋz; hormuzta
isig: ısı, sıcaklık, hararet, sıtma, mülayım, hoş
isür-: serhoş olmak
kantikar: 'Solanum xanthocarupun', (Sanskritçe kantakāri)
serinç: tad, lezzet, hoşluk
tatağlığ: tatlı, lezzetli, hoş
tatığlığ: tatlı, hoş, tatlı
tirti: (Sanskritçe tirthika), inanç hocası
yarağlığ: yakışan, yarayan, hoş, uygun
buz: bozma, yakma, harap olma, tahribat, bkŋz; boz
kö: ün, şöhret
kög: bkŋz; kök, şarkı, Türkü, şöhret, ün
közünç: ünlü, şanlı, meşhur, şöhretli
kü: şöhret, ün, ses, gürültü, şayia
küg: bkŋz; kög, , görültü, ses, Türkü, şarkı, şöhret, ün, sefalet
Küşen: ülke adı, Kuça şehri
meŋizlig: renkli yüzlü, benizli, çehreli, yakışıklı
or: tahr (?)
öŋlük: yüz, çehre
kıvlığ: mutlu, mesut, bahriyar
bantiŋ: oturmaya mahsus sıra
münsüz: günahsız, kabahatsız, suçsuz
sı: Budistlere mahsus manastır
Tarım: kadınlara mahsus bir ünvan, kişi adı
yazuksuz: günahsız, suçsuz, kusursuz
idiş bitig: ruhsat
ohşa-: bkŋz; okşamak
bakşı: bkŋz; bahşi, kişi adı
katır katığ: müthiş, dehşetli
katır yavlak: dehşetli müthiş
tosun: vahşi, kaba, yontulmamış kimse, utanmaz, bkŋz; toosın ~ toosun
orohtik: (Sanskritçe rohita), bir balık cinsi
tohtı: Toharca, bkŋz; tokrı
ban: üzerine yazı yazılan tahta, yazı tahtası, (Çince wan) 'on bin'
buşılığ: sadakaya muhtaç olan
ilen-: saltanat sürmek, devleti idare etmek, bağlı, sadık olmak, ihtişam, saltanat, görkem
kergek: gerek, lazım, görüm, ihtiyaç, gereken şey
kergekle-: lazım olmak, ihtiyaç hissetmek, gereksemek
nızvanlığ: ihtiraslı
nızvansız: ihtirassız
ornağ: taht, ikametgah
orun: yer, mahal, taht, mesken
orunluk: taht
örgin: taht
karı: sayın, hürmetli, muhterem, yaşlı, ihtiyar, karı
karığ: yaşlı, karı, ihtiyarlık
karı-: ihtiyarlamak, kocalmak
karımaklağ: ihtiyarlamaklı
kart: çıban, yara, cıbanlı, kart, ihtiyar
katağ: bkŋz; katığ, sağlam, katı, ceht, enerji, çaba, dürişme
kurta: bkŋz; kurtğa, ihtiyar kadın
kurtğa: ihtiyar kadın
hua: bir çiçek türü
hul: kul, köle
hulğak: kulak
hunçui: kunçui, prenses, lakaptır
hun-: bkŋz; kunmak, çalmak
hurkak: bkŋz; kurkak
hursadıl-: kuşatılmak, çevrilmek
hurtul-: kurtulmak
huş: kuş
hutad-: kutlaştırmak
hutğar-: kurtarmak
hutrul-: kurtulmak
çarihuş: (Ir.çarhuşt), üzüm sırası mengenesi
muhurta: (Sanskritçe), zaman, vakit tayini ölçüşü, günün bir kısmı
tohum: bkŋz; toğum
tohur-: bkŋz; toğurmak
inek: husye, taşak (?)
mayaka-: hudut işaretlerini yerine çakmak
kıdığ: hudut, sınır, kıyı, kenar
üskinte: huzurunda, katında, nezdinde
bark: hükümdar sarayı, ev, mülk
ilig: hükümdar, kral, el, asılmış, ilişik
yinçür-: hürmet etmek, eğilmek, baş eğmek, saygı göstermek
ar-: aldatmak, yorulmak, girmek, hülül etmek
boşan-: serbest, hür olmak, başına buyruk olmak
İdikut: Basmıl Türk halkından alınmış hükümdar ünvanıdır, yer adı
il: il, memleket, devlet, hükümdar, bkŋz; el
yitlin-: yok olmak, mahvolmak, yitmek
yokatdur-: imha ve mahvetmek, yok ettirmek, ortadan kaldırmak
tınturul-: ihya edilmek, canlandırılmak
iişi: bkŋz; işi, prenses, şahzade kadın
İl: kişi adı, prens ve şahzadelere verilen ünvan
kan: han, hükümdar, şahzede, kan, kişi adı
tigin: prens, şehzade, ünvan
Surıa: erkek adı
yıba: tamamı, bütünü, hepsi
mun-: başıboş dolaşmak, işsiz güçsüz dolaşmak
oskurdaçı: kurtarıcı, halaskar
kınağuçı: kınayıcı, azap veren kimse, işkence
kız: sıcak, kız, hasis
yarılınçığ: parçalayıcı, ayrıcı
yılığ: ılık, sıcak
yılın-: ılıklaşmak, ılınmak, sıcaklaşmak
buşıçı: sadaka toplayan
kamıç: kepçe, kaşık
karğıçuğun: bir çeşit ilaç
karıç: ölçek
kıçık: kaşıntı
kıçur-: kınamak, ayıplamak
kılıç: kılıç
kolbıç: koltukaltı
kolıçak: kolcuk
sıçı: sınır, hudut
kıdat-: düzeltmek, iyileştirmek
Kıprıdı: kişi adı
Kuda Bıdın: erkek adı
sıdam: sade, düz, süssüz
sıntıda: mezarlıkta
Sısıdu: özel ad
soğıd-: bkŋz; soğıtmak
tıdığ: engel, mania, sed
tıdılmış: yasaklanmış, durdurulmuş, menedilmiş
tıdın-: mani olunmak, yasaklanmak
tıd-: mani olmak, menetmek, yasaklamak
tıdul-: bkŋz; tıdılmak
Tınşıdu: kişi adı
yaltrıd-: bkŋz; yaltrıtmak
yıd: koku, rayiha, ıtır, misk
torığ: doru, zayıf, bkŋz; toruğ
toruğ: güçsüz, zayıf, kuvvetsiz, bkŋz; toruk
toruk: bkŋz; toruğ, bkŋz; turuk, zayıf, berrak, duru, ısık, bkŋz; turuk
ı tarıg: ekin
kergeklıg: gerekli, lüzumlu
saŋıg: manastıra ait bir yemek
oŋalı: vazıh, açık, belirli, belli
T (e) ŋriken: tanrıhan, kişi adı, unvan
kıınlık: hapishane, ceza evi
kınçı: bkŋz; kıınçı
kıyınlık: bkŋz; kıınlık, hapishane
alsık-: çalınmış aldanmış olmak
balıkçı: balıkçı
banmık: bir hastalık türüdür
Basık: bir vergi
bastık-: basılmış olmak
başık: Türkü, şarkı
batsık: batış
barıl-: varılmak
batıl-: batmak, batmış olmak, gömülmek
boşılığ: kurbanlık
inç kıl-: sakinleştirmek
it yılı: on iki hayvanlı türk takviminin onbirinci yılının adıdır
barım: zenginlik, servet, varlık
barımlığ: zengin, varlıklı
birim alım: vergi, borç
ıtım: bkŋz; ıdım
Kalım: kişi adı
Kalımtu: kişi adı
Kanımudu: kişi adı
Karımış: kişi adı
Karımtu: kişi adı
Kayımtu: kişi adı
kılımsın-: yapıyor gibi davranmak
kımız: bkŋz; kumuz
Kıyımtu: kişi adı
salkım: soğuk
sımnanç: bkŋz; şımnanç
sımtak: derbeder, tenbel, avare, aylak, bkŋz; sımtağ
sımtal-: harekette olmak, gitmek, terketmek
talım balığ: deniz canavarı
tamızım: damla
tapımça: arzumca, keyfime göre
Kıpçak: kişi adı
kıpçur: bkŋz; kopçır
kıpkızıl: kıpkızıl, kıpkırmızı
sıpar: misk
yıpar: misk, koku, rayiha, ıtır
yıparlığ: kokulu, ıtırlı, rayihalı
yıt yıpar: misk, rayiha, ıtır
itig: yitig, kayıp, süs, bezek, tezyinat, tesis, kurum, yapı, müzik aleti
kiŋ: tıpkı, aynı, tam, en, genişlik
kiŋürü: tıpkı, aynı, tam, geniş bir surette
kolğur-: yalvarıp yakarmak
kovıt-: tahrip etmek, harap etmek, yakıp yıkmak
sıt-: kırmak, sıkıp çıkarmak
sus-: çarpmak, daldırıp almak
teg: gibi, , tek, benzer, tıpkı, edat
yalaŋ: çıplak, yalın, bkŋz; yalıŋ
yalıŋ: yalın, çıplak, bkŋz; yalaŋ
yapar: yıpar
ır: şarkı, türkü, bkŋz; ir, kuzey
ırak: ırak, uzak
ırğak: kanca, çengel, kopya
ırğal-: sallanılmak, silkilmek
ırk: iaşret, rümuz, falcı
ırkal-: ırgalanmak
ırla-: şarkı, türkü söylemek
altı kırk: otuz altı (36)
altırar: altışar
ısır-: ısırmak
ısıt-: ısıtmak
Mısır: kişi adı
Mısır Sıla: kişi adı
nısan: bkŋz; nışan
kadıs: bkŋz; kadız
kalısız: eksiksiz, tam olarak, kalıntısız
karşısız: kavgasız
Kınısun: kişi adı
kısağ: bkŋz; kısığ
kısak: kişi adı
Kısamuk: bkŋz; kızamuk
kısğa: kısa, az
kısğaç: kıskaç, bkŋz; kıskaç
kısıl: dere, vadi, dağ boğazı, çukur, küçük geçit
Kısıl: yer adı, yer adı
kısıl-: kısılmak, darlaşmak, daraltmak
kısırın: bir bitki adı
kıs-: kısmak, çimdiklemek
kıskaç: kıskaç, bkŋz; kısğaç
kıskan-: kıskanmak
Sısır: özel ad
sısğur-: erimek
sıs-: kırmak, koparmak
sıslağ: sızıntı, ağrı
sıslat-: sızlatmak
Tısak: kişi adı
Urıslum: kudüs (şehir), bkŋz; Urışlım
utlısız: karşılıksız, mükafatsız
yakıs: yağlı olan şey, bkŋz; yağış
yavısku: bkŋz; yavışğu
ış: bkŋz; iş
alkış: övme, kutlama, taktis, hayır dua
altmış: altmış (60)
Altmış Kara: özel ad, kişi adı
Altun yış: yer adıdır
Barça Turmış: erkek adı
Bark Turınış: kişi adı
Bayutmış: kişi adı
Bulmış: kişi adı
İl Almış: kişi adı
İl Kudatmış: kişi adı
İl Katmış: kişi adı
Kenç Turmış Tarhan: vekil lakabı, ünvanı
ıt: bkŋz; it
ıtala-: dağıtmak
ıtar-: uzaklaştırmak
banıt: şurup
basıt-: basılmak, tazyik edilmek
okıt-: okutmak, ezbere söyletmek
kavıt-: çarpışmak
kıvırkan-: hasislenmek, hasislik etmek, cimrilik etmek
kıvırkaklan-: hasislik etmek, cimrilik etmek
tıvar: bkŋz; tavar, davar
yıvlğu: bkŋz; yıvılğu
yıvılğu: bir çeşit ağaç
yıv-: övmek
batır: sıvı ölçüsü
köne: suvı kelimesiyle birlikte cıva
kıyırkak: bkŋz; kıvırkak
kıyırkaklan-: bkŋz; kıvırkaklanmak
suva-: sulamak, ıska etmek, sıvamak
suvatçır: bir ilaç adı, bkŋz; şıvaçır ~ suvatsır ~ şıvastşır
ulın-: çevirmek, ihata etmek, kuşatmak, kıvranmak, inlemek
yvlğu: bkŋz; yıvılğu
ıya: bkŋz; ıye
ıyın: yavaş yavaş, gittikçe, bkŋz; iyin
ıyınç: bkŋz; iyinç, tazyik, baskı
ıy-: basmak, ezmek
katığ kıya: çok sert, kavi, berk
kıy: sınır, hudud, mahalle
kıya: bkŋz; kına
kıyand: gergedan
kıyçe: yakında olan, uzakta olmayan
Kıyıntu Toyın: erkek adı
kıyık: çarpık, kıyılmış, eğri
Sanıyınç: özel ad
Surıy: kişi adı
Surıy Aşırı: kişi adı
Tıyuk: yer adı
yıyıl-: bkŋz; yayılmak
balu: bağlıyor
başsız: başsız
buyansız: sevapsız
priankari: bir prensin adı
priaŋu: bkŋz; piraŋu
yantut bitig: iade belgesi
tosku: mania, engel
toş: tabiat, (Sanskritçe dosa)
una: bkŋz; ona, şimdi, hemen, bkŋz; knia, 'daha'
urunçak: rehin, emanet, vedia
yanut bitig: geçiçi iade belgesi, sözleşmesi
yaraş: yaradılış, tabiat
yaraşı: yaradılış, yakışır, tabiat, süs, bezek, tezyinat
kiber-: yırtılmak, patlamak
Semsibe: kişi adı
Teŋribirmiş: kişi adı
Tibin: kişi adı
yibün: kırmızı
altunluğ: altınlı, altınla süslenmiş, altın gibi
isman: (Tibetçe sman), ilaç nevi
irzi: öğretici, muallim, arkadaş
kemiçi: gemici
öte-: ödemek (borç), müracat etmek, ricada bulunmak, neşet etmek, çıkmak
özirken-: rica edilmek, geri getirilmek
kol-: rica etmek, dilemek, istemek
kolunluğ: merhamet ederek, rica yollu
kolun-: dilenmek, rica etmek, yalvarmak
ktpl: (Sanskritçe katphala), myrica sapida
satığ: satış, muamele, ticaret
sığın-: sığınmak, iltica etmek
Tapan: (Sanskritçe tapana), sekiz sicak cehennemden altıncısı
taşdın: dışarıdan, haricen
tavar: davar, mal, ticaret eşyası, Çin kumaşı
İkiçi: kişi adı
İkiç toyın: kişi adı
irbiç: bkŋz; irbiz, porsuk
idil-: süslenmek, süslenilmek, donanmak
idiş ayak: mutbak kapkacağı
idiz: yüce, yüksek
id-: kaybolmak, yitmek
ikid: bkŋz; igid
isid-: ısıtmak, bkŋz; isitmek
işidil-: bkŋz; işitilmek
kid: son, nihayet, arkada
kidin: arkadan, karşı yaka, sonra, batı, keten
ertür-: yapmak, işlemek, tamamlamak, ifa etmek, kabullenmek
kigür-: sokmak, gidermek, ifa etmek, getirmek
kövşek: zarif, güzel, şık, yumuşak
on-: sağlamak, onarmak, tedavi etmek, şifa bulmak
öŋed-: değişmek, iyileşmek, şifa bulmak
tokılığ: zarif, şık, endamlı
tuman: duman, sis, karanlık, zifiri karanlık
tutğur-: yapmak, ifa etmek, kurmak
tütüşlüg: düşman kesilme, muhalif olma, bkŋz; tüdüşlüg
ig: hastalık
bitig taş: abide, yazıt, yazılı taş
baş bitiğ: ana vesika, temek belge
berkliğ: berk, pek, sağlam
boş bitiğ: serbestlik, özgürlük belgesi
muiğa: inat, laf anlamaz
muiğak: dişi geyik
münçiğ: kadın mayası, uterus
süçiğ: bkŋz; süçüg
Uiğur: bkŋz; Uyğur
ersi-: iğrenmek, kösnümek, kolasamak
yirinçülüg: iğrenç, kötü, bkŋz; yirinçlig
Mşiha: İsa
tak: ihtiyaç, angarya
ulınçığ: ihata edilerek, çevirerek, kuşatılarak, devamlı
ilkii: bkŋz; ilki
yiig: bkŋz; yig, daha iyi
yiil: bkŋz; yil, rüzgar
şlok: (Sanskritçe sloka), şiir, nazım, vezin
taksur-: beyit, şiir okumak, inşat etmek
takşut: şiir, beyit, manzume, nızam
ik: kenar, kıyı
ikegü: ikisi bir arada
iki: iki
ikigü: bkŋz; ikegü, her kişi
ikikü: bkŋz; ikigü
ikil: bkŋz; igil
ikin: tekrar, yeniden
ikin ara: ikisi arası
ikindi: bkŋz; ikinti
ikinti: ikinti, öteki
ikirer: ikişer
ikir: bkŋz; igit
birik-: birikmek, toplanmak
birikli: birikmiş
bişik: beşik, parça
çatik: (Sanskritçe Jataka), doğum hikayesi, bkŋz; çadik
ildiş-: kavga etmek, itişmek, bkŋz; iltişmek
ilgün-: tesir etmek, etkilemek
ilig kan: kral, padişah
ilik: bkŋz; ilig
iliksiz: elsiz
ilin-: yapışmak, asılmak, ilişmek, takılmak
ilintür-: astırmak, iliştirmek, taktırmak
ilit-: bkŋz; iltmek, götürmek, taktırmak
iliş: ilişme, takma, yapışma
ilk: ilk
ilkün: halk, millet, bodum
il-: basmak, saldırmak, birisinin üzerine atılmak
iltin-: sevkedilmek, götürülmek, iletilmek
iltiş-: münakaşa etmek, itişmek, kavga etmek, sevkedilmek
iltü: oraya
iltür-: iletmek, göndermek, götürmek
im: em, ilaç
imer-: çevirmek, kuşatmak, rahatsız etmek, çekmek
imren-: imrenmek, arzu etmek
birim: borç
ertimlig: ölümlü, geçimli, fani, fanilik
kilimbi: şeytan adı
Kimbağ: (Çince) varak halinde altun
kimi: gemi, bkŋz; kemi
kim-me: kim olursa olsun
Kimensü: kişi adı
Kimünsü: kişi adı
inç: rahat, huzur, sakin, sükünet, sulh, sakin
inç tur-: müsterih olmak, rahat olmak
Inçiu: yer adı
indin: sınır, hudut
inerü: bkŋz; ınaru
ingek: inek
ini: küçük erkek kardeş
inkek: bkŋz; ingek
in-: inmek
intür-: indirmek, ezmek, bastırmak
inyana: (Sanskritçe Ināna), bilgi
Mhakip: (Sanskritçe Mahākalpa)
neŋ inçip: ne olursa olsun, mümkün olmayan
Sariputri: özel ad
Sip-başı: yer adı
sipir-: süpürmek, temizlemek
tripal: (Sanskritçe triphālā), myrobalane
yip: ip, iplik
yipin: menekşe rengi, bkŋz; şipkin ~ yipkün
yipke: iplik
yipkin: bkŋz; yipin, menekşe rengi
yipün: bkŋz; yipkin, Lotüs çiçeği
Yosipas: kişi adı
torku: ipek
uruk: ip, kendir
iravadi: bkŋz; erivadi ~ irivadi
irbiz: bkŋz; irbiç
irig: iri, kaba sapa, iriyarı
irin: kenar, kıyı, dudak
iriŋ: bkŋz; yiriŋ, irin, cerahat
irinz: bkŋz; irinç
irivadi: bkŋz; erivadi
irk: koyun
irkek: erkek
irkeklen-: erkekleşmek, kişileşmek
irkle-: bir şeyin üzerine çıkmak
irle-: bkŋz; ırlamak, türkü söylemek, şarkı söylemek
irpek: bıçkı, kesme aleti
irpiç: vaşak, bkŋz; irpis
irsi: (Sanskritçe rsi), peri, ilah
irt: bkŋz; birt, vergi
irte: erte, yarın, sabah erken
irteken: erken
irteki: yarınki
irtekün: sabah, yarın, erte
irt-: devam etmek, sürmek
is: bkŋz; iş, eş, dost, arkadaş
isi: bkŋz; işi
isiç: kazan
isil-: eksilmek, azalmak
isi-: ısıtmak, ısınmak
isirgen-: bkŋz; isirkenmek
isirkegü: merhamet, hasislik
isirken-: merhamet etmek, esirgemek
isit-: bkŋz; ısıtmak
isiz: kötü, fena, kaba
iske-: ditmek
isle-: aramak, koklamak
issiz: ilaç olarak kullanılan bir bitki türü
istem: istek, arzu, dilek
iste-: istemek, aramak, arzu etmek
bis: bkŋz; biş
bisük: bkŋz; bişik, nesil, akrabalık, soy, sop
işi: kadın, hanım, eş, hatun, zevce, prenses, tanınmış, yüksek tabakaya mensup kadın, hanım
işiç: bkŋz; isiç
işik: eşik
işin: saç örgüsü
işit-: işitmek
işitil-: işitilmek
işkirti: bkŋz; işgirti, ipek kumaş
iş küç: işgüç, emek
işle-: işlemek, çalışmak
iştil-: bkŋz; işitilmek
iş tuş: arkadaş
iştür-: anlatmak, bildirmek, hikaye etmek
işsüg: çalışkan
biriş: veriş, verme
biş: beş
bişük: bkŋz; böşük
it: it, köpek
iterçi: şahinci, doğancı, kuşçu
iter-: takip etmek, arkasınca gitmek
iti: keskin
itil-: yapılmak, donatılmak, tekemmül etmek, gelişmek, süslenmek
itin-: süslenmek, hazırlanmak
itiz-: müzik aleti çalmak
it-: düzenlemek, tertip ve tanzim eylemek, süslemek, hazırlamak, etmek
itüg: dilek
it üzümü: yabani üzüm
baramit: (Sanskritçe paramitā) çare yolu, halletme yolu [dini]
bit: bit, bet, beniz, yüz
biti-: yazmak, koyya etmek
bitil-: yazılmak
bititkü: yazdırma
bitit-: yazdırtmak, yazdırmak
oŋlium: evangelium, incil
yunkiu: (Çince uen-kü), Büyük Ayı'nın yıldızlarından biri
sakabir: 'Amonium zingiber'ilacı
ivin: bkŋz; evin
ivinki: sıradaki
iv-: bkŋz; iymek, basmak, tenkil etmek
Mokşadivi: özel ad
sivinç: bkŋz; sevinç
sivin-: bkŋz; sevinmek
siv-: bkŋz; sevmek
sivsin-: terkedilmiş olmak
yivik: bkŋz; yivek, malzeme
yiviklig: bkŋz; tiziklig, acul, aceleci
iye: bkŋz; ige, sahip, sonraki, devamı
iyi: mal-mülk, servet, emlak
iyinç: kovalamak, takip
iyin-: basılmak, ezilmek
iy-: basmak, ezmek
kiyik: bkŋz; keyik, geyik
miyi: beyin
Supriya: özel ad
tiyiş-: söyleşmek
buyançı: iyilik sever, din adamı [hukuk]
buyanla-: iyilik etmek, hizmet etmek
oŋul-: iyileşmek, sağalmak
tartın: iyilikseverlik
tenil-: iyileşmek, zail olmak, salah bulmak
yakşı: iyi, ala
yig: iyi, daha iyi, tercihen, yeğ görüp, çiğ, ham, olmamış
iz: iz
berksiz: sağlam olmayan, çürük
birtsiz: vergisiz
biz: biz
erksiz: güçsüz, kuvvetsiz
usik: bkŋz; ujak
uzak: bkŋz; ujak, uzak, uzayan, süren
uzik: bkŋz; ujak
küsi: bkŋz; küji, misk
küzi: bkŋz; küji
kat: kat, tabaka, kat kat, defa, kez, mitolojik bir hayvan
Tuşit: bkŋz; Tujit
baş bitig: asıl (orjinal) yazı
ka: arkadaş, akraba
kab: torba (ölçü olarak), desilitre ve benzerleri, deriden torba
Kaban: kişi adı
kabak: kabak, göz kapağı
kabar-: bkŋz; kaparmak
kabuçak: kovuk
kaç: kaç, ne kadar
kaçan: ne vakit, ne zaman, vaktaki
kaçaŋ: kaç defa, o kadar, kaç kez
Kaçan Küke: kişi adı
kaçığ: duyu organı, kaçak, kaçık, geçit, ara
Kaçırsu: kişi adı
kaç kata: çok kez, çok defa, çoğu, ekseriyetle
kadağ: kusur, kabahat, suç, günah, bkŋz; katığ
kadak: bkŋz; kadağ, bkŋz; katağ
kadaş: arkadaş, akraba
kadığ: bkŋz; katığ
kadın: memleket adı, kayın (peder)
kadın-: pişman olmak, nedamet etmek
Kadır Bilge: kişi adı
Kadırkan: ormanlı bir dağın adı, yer adı
yaz: yaz, ilkbahar
Borlukçı: kişi adı
Ökçüŋ: yer adı
ötekçi: borçlu, ödeme zorunda olan kimse
Tarıkçı beg: erkek adı
tötükçi: hakim
tuzakçı: tuzak kurucu, tuzakçı
Türkçe: Türkçe
yakçırt-: düşünmek, tahrik etmek, muhakeme etmek
Yelekçi: kişi adı
yokça: yok gibi
ken: ve kendi, sonra, açıkça
öküşti: çokça, bolca, sık
Yam: (Sanskritçe Yama), bir tanrı adı, (Türkçe erklig kan)
ötüg bitig: dilekçe
sıkda-: ağlamak
Tailekdü: kişi adı
yakdur-: yaktırmak
kügül-: takdis edilmiş olmak, tanınan
küle-: methetmek, övmek, takdir etmek
müne-: kötülemek, tekdir etmek
Saldır-: sunmak, takdim etmek
soyurka-: takdim etmek, sunmak
tapla-: tapmak, lütfetmek, takdir etmek, hak vermek
yimki: takdis, kutlama, kutlu kılma
yok-: takdir etmek, yükseltmek
kekre: ilaç olarak kullanılan bir bitki
korkğu: korku
Urumuki: (Sanskritçe Urumkha), bir şeytanın adıdır
kı: bkŋz; şi, ünlem karşılığı söylenen söz
kı-a: bkŋz; ky-a
kıkır-: çağırmak, seslenmek, bağırmak
kıkuruş-: bağırışmak
kıl: saç, kıl
kıldur-: bkŋz; kılturmak, kaldırmak
kılığ: vergi nevi
kılıl-: kılınmak
kılınç teŋrisi: iş ve hareket tanrısı
kıl-: yapmak, yaratmak, vücuda getirmek
kılmaklığ: bkŋz; kılmaklağ
kıltur-: kıldırmak, yaptırmak
Kına: kişi adı
kıŋ: şaşı
Kıŋdam: kişi adı
ki: arka (-sı, -sında), Çince King-sutra
kiç: geç, zaman, uzun süre
kiçig: küçük, ufak, genç, ufak bir sikke
kiçig baçağ: küçük oruç
kiçig erŋek: küçük parmak
kiçig iş: küçük iş
kidirti: batıda
kidiş-: bkŋz; kitişmek
kidiz: keçe
kid-: bkŋz; kitmek
ki-e: bkŋz; ki (y) e, biraz
kigürsük törü: sunma yasası, kanunu
kikinç: açıklama, izahat, cevap, sonuç
kilen: bkŋz; kelen
Kimzün: kişi adı
kin ağırlık: tenasül uzvu
Takküŋ: kadın adı
altun yartmak: altın sikke
köŋülker-: düşünmek, mülahaza etmek, tefekkür etmek
ötük: edik, ayakkabı
sakınğu: düşünce, tefekkür, düşünme
satır: bir sikke, para nevi
tegere: dair, hakkında (bir şey)
titrü: dikkatle, dik, keskin, sabit
tota-: değersiz telakki etmek, değersiz saymak
utğuratı: köklü, esaslı, temelli, muhakkak, şüphesiz, tamamıyla
utlı: ödül, mükafat, karşılık, teşekkür
antağ oşukluğ: buna benzer, böyle
Barmaklığ: erkek adı, kişi adı
bur-: kokmak, kokutmak
kne: yine, ve, bizzat
kobık: kehrüba, bkŋz; köpük
kobarğa: baykuş
kobaz: kobuz sazı
koç: koç
Koç: kişi adı
Koça: kişi adı
koç-: sarılmak, kucaklamak
Koçu: Koço şehri
koçuŋar: koç
koçuş-: kucaklamak
kodı: aşağı, koyu adı, sağlam, esaslı, pek
kodıkar-: aşağı koymak
kodıkartur-: indirmek, aşağıya koymak, kıymetten düşürmek
kodıkı: bkŋz; kotıkı, aşağıki
kod-: koymak, bırakmak, terketmek, yerleştirmek, ayırmak, çıkarmak
kodur: uyuz, kotur
koduru: tamamıyla, bütünüyle, büsbütün
koğ: toz, atom
koğu: kuğu kuşu
koğulğu: parlak
koğursak: kursak
koğus: bomboş, boş
koğuş: tüylü hayvan derisi, postu
koin: bkŋz; koyın
kok: toz, toprak, pislik
kok-: azalmak, küçülmek
kokpa: pamuklu kumaş
kol: kol
kolğak: bkŋz; kulğak, kulak
kolğuçı: dilenci
köb: bkŋz; köp
köbik: köpük
köbük: köpük
köged-: methetmek
kögür-: yaymak, genişletmek
Kök: kişi adı
Kök-Buka: kişi adı
köked-: yükseltmek, övmek
Kök-öŋ: bir nehir adı
köküz: bkŋz; kögüz
köküzlüg: kalbe yakın ve kıymetli olan, bkŋz; kögüzlüg
kölük: yük hayvanı
kölüŋgü: taşıt, taşıma aracı
krü: bkŋz; kirü, geri
kra: bkŋz; kara
krar-: bkŋz; kararmak
krarığ: karanlık, zülme
krüç: bkŋz; kürüç
bakr: bkŋz; bakır
ertukrak: bkŋz; artukrak
Ökrünç: özel ad
Ökrüs Temür: erkek adı
tokrı: bkŋz; tohrı
Tükrünç: kişi adı
yakrı: yağ
ykrmi: bkŋz; ygirmi
yürekre: yüreğine
ksānti: bkŋz; kşanti
kergeksiz: lüzümsuz, gereksiz
kirikse-: girmek istemek, yeltenmek
könüksü: gümüş suyu
körksüz: çirkin, yakışıksız
oksa-: bkŋz; okşamak
özeliksiz: yüksekliği büyük olmayan, üstünsüzlük, üstünü olmayan
karmaksız: karışıksız, katıksız, katkısız
setreksiz: bkŋz; sedreksiz
siziksiz: şüphesiz, kaygusuz
suksuz: tok gözlülük, ihtirassızlık
kşanti: nedamet, ikrar duası, itiraf, tövbe
kşi: bkŋz; kişi
okşağu: misal, emsali, örneği, benzeri
okşa-: benzemek
okşatı: benzer
okşat-: benzetmek
Kara Bakşı: erkek adı
sukşumur: bkŋz; suksumur
yakşa: (Sanskritçe yaksa), şeytan, bkŋz; yaksa
yakşıçı: idareci
yekşembi: pazar günü, yekşenbe
yookşastr: (Sanskritçe yogaşâstra)
İktü: kişi adı
kamrakttı: (Sanskritçe Kāmarakta), bir lakaptır
silktür-: ötmek, seda vermek
Sokta: kişi adı
Soktu elçi: erkek adı
tiktaka: (Sanskritçe) acı
Toktamış: erkek adı
Toktı: erkek adı
uktur-: anlatmak, açıklamak, izahetmek
birle: ile, birlikte, beraber
Kurudis: kişi adı
ku: bkŋz; kua
kua: (Çince hua), çiçek türü
Kuba Çakırça: erkek adı
Kuçaŋ: kişi adı
kuç-: kucaklamak
kuçul-: kucanmak, kucaklanmak, koculmak
kud: bkŋz; kut
kudad-: bkŋz; kutatmak
kudat-: kut dilemek, kutlamak
Kudatmış: kişi adı
kud-: bkŋz; kutmuk
kuduğ: kuyu, pınar, deniz
Kuduğu: kişi adı
kuduru: bkŋz; koduru
kuduz: su kuyusuyu
kuin: (Çince k'üen), kitap yaprağı
kul: kul, köle
kulaç: kulaç
kulak: kulak
Kula Kara: erkek adı
Kulan: erkek adı
kulğak: kulak
kullığ: bkŋz; kılluğ
kulkak: kulak
kulsığ: köleye yakışır, köle gibi
kulun: bir çiçek türü
kulunla-: at doğurmak, at tay vermek, gunlamak
Kulun Kara: erkek adı
kum: kum
Kumar: kişi adı
kumari: (Sanskritçe kumāra), Kamarupa kralının adı
kumaru: veda, ayrılış
Kumaş bay: erkek adı
kuma yağı: kenevir yağı, bezir yağı
kumlağ: kumlu
küç: güç, kuvvet, zor
Küç Temür: erkek adı
Küger: bkŋz; Kögür
kügettür-: bkŋz; kökettürmek
Kügür: bkŋz; kögür
küi-: bkŋz; küymek
kük: bkŋz; kök
Küke: kişi adı
kül: kül
Kül-Bilge Kağan: Hakan ünvanı
külçir-: gülümsemek
Kül-çur: kişi adı
küldi: yüzbin
kül-: gülmek
Kül-kağan: hakan ünvanındır
bars: kaplan, pars, on iki hayvanlı Türk takviminde bir yıl adı, özel ad, kişi adı
koyın: koyun, Türklerin onikili hayvan takviminin bir yılı
takığu: Tavuk, Türkler'in on ikili hayvan takviminin bir yılı
tavışkan: tavşan, 12'li hayvanlı Türk takviminin bir yılı
yılan: yılan, yıl kelimesiyle oniki hayvan takviminin bir yılının adı
yont: at, Türklerin onikili hayvan takviminin bir yılı
kye: ve, bizzat
taluy: deniz, umman, okyanus
tekzim: pamuktan ve başka nesneden yapılmış kabartma
turğur-: durdurmak, diktirmek, rekzetmek
yalbar-: bkŋz; yalvarmak
yalbırğak: yaprak
yilbi-: esmek, yelpaze sallamak
artur-: kandırmak, celb etmek
körkle: bkŋz; körtle, güzel, dilber
körtle: güzel, dilber, prenses lakabı
ör-: yükselmek, çıkmak, bir çeşit elbise
ton: giyecek, elbise, don
tonağu: giyecek, elbise, giyim, bkŋz; tonanğu
tonanğu: giyecek, elbise, giyim, sarılan şey
tonsuz: elbisesiz
urbak: elbise, giyecek
yapırğak: yaprak, bkŋz; yapırkak, bkŋz; yalbırğak
yoğurkan: üst elbise, giyim, örtü
baya: önce, evvelce
könilig: adil, dürüst, adilce
öŋre: önce, evelce, vaktiyle, doğuda, şarkta, ileride
sarir: kılıç arlığı, (Moğulca şaril)
sügül: sivil, sivilce, kabarık
umuğ: umut, mesnet, sığınak, melce, dayanık
yolkı: yolcu, yoldaki, yola çıkmış kimse
Kan elçi: kişi adı
Kurla Elçi: erkek adı
yalçıt-: iştirak etmek, katılmak
batman: batman, ölçek
bukay: alçak, aşağı, kısa
küri: litre, ölçek, kile, kürek
kürilik: desilitre, ölçek, hacim ölçüsü
kamkı: pamuklu kumaş ölçüsü
kav: küçük bir ölçü
kotıkı: basık, aşağıdaki, alçaktaki
sığ: arazi ölçüsü
Burulday: kişi adı
Solda: özel ad
Solda Bay: özel ad
toruldur-: süzmek, berraklaştırmak
turuldur-: bkŋz; toruldamak
yıldız: bkŋz; yıltız
yoldurğan: bir bitki adı
yulduz: bkŋz; yultuz
al-: elde etmek, almak, evlenmek
tilve: bkŋz; tilfe
ürüŋ baş: alfabe
ölgülüg: ölüm halinde olan, can çekişen, ölüm derecesinde hasta olan
tilgen: çarh, daire, tekerlek
olğur-: oturmak, durmak, oturtmak
olğurt-: oturtmak
ozğu kurtulğu: kurtulmuş olmak
kutrulğu: kurtuluş, halas
Salğar: özel ad
talğuk: kazık, çivi
tolğak: hastalık, eziyet, ızdırap, sıkıntı, keder, sancı
tolğa-: incinmek, kederlenmek
tolğan-: incinmek, rahatsızlanmak, dönmek
tolğat-: incitmek, rahatsız etmek, ıztırap vermek
tolğuk: bkŋz; tolğak
yalğa-: yalamak, bkŋz; yalkamak, okşamak
yalğan: yalan
yalğuz: yalnız
yulğak: bkŋz; yulak
ölütlük: salhane, mezbaha
alk-: azalmak, bitmek, tükenmek, sona varmış olmak, sona ermek
aŋ'ilki: ilk
bulkak: bkŋz; bulğak
bulka-: bkŋz; bulğamak
bulkan-: bkŋz; bulğanmak
kalkan: kalkan
kolkak: bkŋz; kolğak
Sılka: özel ad
silk-: silmek
talkan: un
köŋüllüg: akıllı, ferasetli, müdrik, gönüle yakın, sevilen
tökellig: bkŋz; tügellig
tükellig: tekmil, kamilen, noksansız
yolluğ: kutlu, mesut
baskuk: kaya parçası, Milli marş
ölmek emgek: ölüm, can çekişme
ölmeklig: ölümlü, fani
Kurtulmış: kişi adı
telmir-: aramak, hasretini, çekmek, yalvararak bakmak, niyaz edercesine bakmak
yayılmaksız: tereddütsüz, duraklamadan
kolŋa: bkŋz; koluŋa
tilŋeŋ: kargaşalık
yalŋuk: yalnız, tek
ylŋuk: bkŋz; yalŋuk
tek: bkŋz; teg, yalnız
yalaŋuk: bkŋz; yalŋuk
yalaŋuz: yalnız, bkŋz; yalaŋus
yalıŋuk: bkŋz; yalŋuk, insan
taloi: bkŋz; taluy, bkŋz; talay
talay: deniz, büyük nehir, bkŋz; taluy ~ taloi
tolp: bütün, hep
yılpığ: zırnık
tötüşlüg: düşman kalpli, düşmanlık, bkŋz; tütüşlüg
yaykal-: sallanmak, yalpa vurmak, tereddüt göstermek
köŋülsüz: akılsız, manasız, idraksiz
ulsuz: dipsiz, köksüz, zeminsiz
kur: kemer, toka, sıra, silsile
sıŋ: dağ silsilesi, sıradağ
tizig: dizi, sıra, silsile, gerdanlık
törüsüz: kanunsuz, nizamsiz, usulsüz
turğınçara: derhal, behemehal, ne olursa olsun
tüpsüz: köksüz, temelsiz, esassız, dipsiz
ulağ: zincir, silsile, sıra, irtibat, ulak, yük hayvanı
altı: altı (6)
altınkı: alttaki, aşağıdaki
baltır: baldız
balto: bkŋz; baltu
baltu: bkŋz; balto
Baltur: kişi adı
bultur-: buldurtmak
bultuk-: bulunmak
keltür-: getirmek
kültür-: güldürmek
oltırık: sütun
oltur-: oturmak
oŋalt-: düzeltmek
kaltı: nasıl, eğer, ...dığı gibi, yanı, ....ince, ki
borluğ: bkŋz; borluk
borluk: üzüm bağı
kirtülüg: mümin, inanmış kimse, dindar kimse
kizlegülük: saklanan, gizlenen
köplüg: şiş, şişlik
körklüg: güzel
kösüşlüg: arzulanan, istenen, dilenen
kötlür-: bkŋz; kötrülmek
közünlüg: güçlü, kuvetli
külüg: bkŋz; külüŋü
yalvar-: yalvarmak, dilemek, istemek, niyaz etmek
yelvi: sihir
yilvi: sihir, büyü
yilvile-: sihirbazlık yapmak, kamlamak, sihirlemek, büyülemek
yalına-: alevlenmek, yanmak, parlamak, bkŋz; yalınmak, niyaz etmek, dilemek, yalvarmak
yrval-: bkŋz; yalvarmak
ulyak: temel, pençe, taban
burçak: bezelye, burçak
Yar: irin, cerahat, tükürük, salya, bkŋz; tüz, taş halindeki tuz
üntür-: sunmak (malzeme, ekin), göndermek, çıkmak, yükseltmek
Sambodu: erkek adı
Sambun: erkek adı
tamburi: tambur
tembin: mayı ölçüsü
timburi: tamburcu, tambur çalan
tenbin: bkŋz; tembin
tıŋçan: kandil, lamba
yalavaç: elçi, peygamber, yalavaç
yula: meşale, bomba
nomça: nizamca, törece
nomçı: vaiz
kamçı: kamçı
Korumçi oğul: erkek adı
tuzumçı: yol kesen
berke: bkŋz; kerge, kamçı, bkŋz; birke
kağal: bkŋz; kağıl, kırbaç, kamçı
kağıl: bkŋz; kağal, kırbaç, kamçı
şüt: sakin, sessiz, sade, dik, dimdik, düpedüz
uluğ ilig: büyük hükümdar
yügerü: hazır, mevcut, halen, şimdiki
men: ben (zamir)
meŋ: ben, hal, tarz, yem
Meŋ-aş: av, hububat yemeği
meŋile-: sevinmek, neşelenmek, eğlenmek
meŋilig: kutlu, mesut, mutlu, memnun, neşeli
meŋiz: beniz, görünüş
meŋisiz: renksiz, benizsiz, soluk
meŋset-: benzetmek
meŋü: sonsuz, ebedi, ezeli
meŋülük: sonsuz, ebedi olan
Meŋü Temür: kişi adı
Meŋlig Seŋün: erkek adı
meniŋ: benim
meŋzet-: benzetmek, karşılaştırmak
Merkit: kişi adı
ömgekle-: sürünmek, imeklemek
ömgen: boğaz, boyun şiryanı
nışan: Nişan, damga, mühür, alamet
tamğa: damga, mühür
tamğala-: damgalamak, mühürlemek
mğaraç: maharaca
kamğağ: bkŋz; kamağ
kamğak: sarımsak
kamğun: bkŋz; kamağun
Tamğaç Tarık: erkek adı
tamğan: bir ünvan
tamğak: damak
tmğa: bkŋz; tamğa
yamğur: yağmur
yumğak: yumak, yuvarlak
yumğakla-: yuvarlak biçime koymak, hap yapmak, yuvarlaklaştırmak
tmka: bkŋz; tamğa
Mha-prti-a: bir 'sastra' adı
Mhaşaravak: (Sanskritçe Mahās'ravaka)
Mhayan: (Sanskritçe mahāyāna)
Mhayana: kişi adı
tarkar-: uzaklaşmak, sıkıştırmak, dağıtmak, imha etmek
yodun: imha etme
yoklunmaksız: imha edilemeyen, yok edilemeyen
mına: bkŋz; muna
mıŋ: bin
Mıŋ Kara: erkek adı
Mıŋ Temür: erkek adı
mır: bal
mırç: biber
Ozmış: kişi adı
kamığ: bkŋz; kamağ
kamığu: bkŋz; kamağu
kamığun: bkŋz; kamağun
min: ben (zamir), un, çorba
Mina: (Sanskritçe Mina), bir yıldız adı
miŋ: bin (sayı)
miŋiz: boynuz, bkŋz; müŋüz
miŋlik: binlik, binlerce
miŋü: binek hayvanı, at
mini: beni (zamir)
min-: binmek
Minsin: kişi adı
minte: bende (zamir)
mintin: benden (zamir)
mir: bkŋz; mır
miskiç: kedi
mitik: itikatsız, ınançsız, dinsiz
Mitri: bkŋz; Maitri
İl Kirmiş: kişi adı
İl Temir: kişi adı
kemi: gemi, kayık
kemis-: bkŋz; kemişmek
kemişil-: bir yana atılmış olmak
yomkı: bütünü, hepsi, hep
yumkı: bkŋz; yomkı, hepsi, tekmili
oruk: yol, çare, imkan
timin: demin, derhal, yeniden, mümkün olduğu kadar
baramlığ: bkŋz; barımlığ
kemlig: hastalıklı
nomlatıl-: nomlanmış olmak
ölümlüg: ölümlü
kanamlığ: bkŋz; kanamlağ
simle-: eritmek, ezmek
tamlığ: duvarlı, verimli, bereketli
tegimlig: layık, olma, müstehak, ilişiği ve liyakatı olmak
tekimlig: bkŋz; tegimlig
tomlı-: soğumak
tomlıt-: soğutmak
tomluğ: somurtkan
tumlığ: bkŋz; tumluk
tumluğ: soğukluk, soğuk
e-: emmek
köm-: bkŋz; könmek, gömmek
serin-: beklemek, tutunmak, tahammül etmek, katlanmak, dayanmak
serkür-: karşı gelmek, mani olmak, tahammül etmek, dayanmak, katlanmak
ser-: tahammül etmek, dayanmak, katlanmak, durmak, sebat etmek, duraklamak
siŋür-: yutmak, emmek
sor-: emmek
tolum: tam, mükemmel
umunç: umma, umut
umun-: ummak, ümidetmek
umuş: umma
yum-: yummak, kapamak
mŋa: bkŋz; maŋa
mŋal: bkŋz; maŋal
mŋi: bkŋz; meŋi
mnsız: bkŋz; mansız
smnanç: rahibe, zahide
şmnanç: rahibe
şmnu: bkŋz; şmnü, şeytan
şmnuluğ: şeytani
Şumnu: şeytan
kenen-: tatmin edilmek, içi rahatlamak, memnun olmak, kendini iyi hissetmek
Pütrük: memnuniyet adı ve derecesi
kantur-: kandırmak, memnun etmek, teskin etmek
kan-: tatmin olmak, memnun olmak
monçuk: inci
Moŋul Buğa: özel ad
moz: boz, kır rengi
matu luŋ: limon
mu: soru edatı, öylemi?, bu, bkŋz; mo
stavari: (Sanskritçe satavari), 'Asparagus racemosus'bitkisi
burku: trompet
yimir-: yıkmak, paramparça etmek
simri-: öğrenmek
yimril-: yıkılmak, çökmek
kızğan-: kıskanmak, hasislik etmek, cimrilik etmek
kızğak: hasis, cimri
saran: eli sıkı, hasis, cimri
tutuz-: havale etmek, teslim etmek, emretmek
nomsuz: kanunsuz, töresiz
tegimsiz: liyakatsız
kişisiz: insansız, boş, kimsesiz
külün-: gülümsemek, sırıtmak
noş: tat, iksir, ebedi, ölümsüz
kamşa-: harekete getirilmek, depretmek, titremek, sallanmak, deprenmek
kamşat-: tiretmek, depretmek, hareket ettirmek, sarsmak, sallatmak
yumşak: yumuşak
Yumşak: kişi adı
yumşa-: yumşamak
konşı: komşu
siŋil: küçük kızkardeş, hemşire
Samtso: erkek adı
tamtul-: tutuşturmak, parlatmak, yakmak, tutuşmak
tamtur-: parlatmak, tutuşturmak, yaktırmak
Tumtur: kişi adı
burkırak: buruk, ekşi, ekşimtrak
Mubarek Koç: özel ad
muimal-: şaşırmak, donakalmak
munçulayu: bu suretle, böylece
munçuk: bkŋz; munçuğ
munda: burada
mundada: bundan
mundağ: bkŋz; muntağ
muŋar: buna
Muŋasus: özel ad
muŋkul bol-: mantıksız olmak
muŋak: dişi geyik
munı: bunu
munılayu: böylece, bunun gibi
munı-teg: bunun gibi
munlar: bunlar
munlayu: böylece, bu suretle
munta: burada
muntada: bundan, burada
muntağ: bunun gibi, böyle, bu kabilden, bu türden, bu neviden
muntırtın: bundan başka, bundan
muntu: bu, bura
muntuda: bundan
murç: bkŋz; mırç
muyum: şaşkın
muz: buz
müle: (Sanskritçe), temel, kök
mün: suç, kabahat, günah, felaket, çorba
müŋü at: binek at
mün-: kötülemek, bkŋz; münemek, binmek, bkŋz; minmek
müren: ırmak, nehir
müyüz: boynuz
İl Temür: kişi adı
kümüş: gümüş
kümüşlüg: gümüşlü
Ötünç Temür: erkek adı
Kara Temür: kişi adı
Kutluğ Temür: kişi adı
Temüke: kişi adı
temür: bkŋz; temir
Temür: erkek adı
Tokluk Temür: erkek adı
artun: kimyon
kürüç: kimyon
sunu: siyah kimyon, Nigella sativa
vrmzt: bir günün adı
küz: güz, sonbahar
küzlüg: güz, sonbahar
konsoluk: erzak deposu, anbar
tapşur-: tenbih ve teslim etmek
tsaŋ: hazine, servet, (Çince) anbar, depo, antrepo, zahire deposu
tümen: onbin, tümen
tümenlig: onbinlik
uzan-: uzanmak, tenbelleşmek, gevşemek
baştın: ilki, önceki
buruŋı: önceki, evvelki
kendir: bkŋz; kentir
kündini: güney
oŋdın: bkŋz; oŋdun
kanda: nerede
karındaş: kardeş
karkandus: bkŋz; karkanadus
nemen: nasıl, ne suretle
nersiki: peri
neteg: nasıl, hangi, herhangi
öküngü: nadim olma, pişmanlık
Saŋgül: kişi adı
yeŋge: bkŋz; yeŋe
yiŋgil: hafif, yüngül
bay: zengin, varlıklı
bayı-: zenginleşmek, varlıklanmak
karaŋğu: karanku
Tanğut: özel ad
tapınğu: tapınılacak olan
tıranğak: tırnak
yaŋğak: yan, taraf
yaŋğu: bkŋz; yaŋku
yaŋğur-: ses çıkarmak, şakırdatmak, çınlatmak
yaŋku: yankı, ses, aksi seda, eko, şıkırtı, bkŋz; yaŋğu
tayıt-: inhiraf ettirmek, kaydırmak
tay-: düşmek, kaymak, inhiraf etmek, sukut etmek
nızbanı: bkŋz; nızvanı
aŋın: onun, omuz
anı: onu
anıŋ: onun
onınç: bkŋz; onunç
kasanığ: sidik
kaşanığ: bkŋz; kasanığ, idrar, sidik
kınığ: şiddetli arzu
kınık: kuvvetli, sağlam, sert
kuyanığ: tavşan
saŋış: sayım
ni: ne
Nikü: özel ad
nirban: bkŋz; nirvana
nirvanlığ: Nirvanaya ait olan
barani: (Sanskritçe Baharanī) yıldız adıdır
Çayasıni: Yayasena, kişi adı
ertini: bkŋz; erdini
İnik: kişi adı
aŋkaru: anlamak, sezmek
kinki: sonraki, sondaki
karaŋku: karanlık
kunku: (Çince k'ung-koo), harfe adı, muzik aleti
şunkar: atmaca, çakır kuşu
ünkür: bkŋz; üŋür
üstünki: en üsteki, en yüksekteki
yaŋkır-: aksetmek, yankılanmak
yaŋkuluğ: akseden, çınlayan, ses çıkaran
yaŋkur-: seslenmek
yaŋkuruş: seda, ses
yankurt-: ses aksettirmek
yankı: tazminat, karşılık, bedel
Ygenkent: yer adı
aŋla-: anlamak
anlar: onlar
buyanlığ: mesut, mutlu, sevaplı
kelinle-: evlenmek
keŋlig: genişlik
kinle-: eritmek, aşındırmak, ufaltmak
köŋle-: hatırlamak, düşünmek, dalmak
küsünlüg: güçlü, kuvvetli
onluk: onluk
oruŋluğ: bayraklı
öleŋlik: çayır, otlak
öŋlüg: renkli
boşunmağ: bkŋz; boşunmak
önmen: bkŋz; örmen
Sanmış: özel ad
Tınmış: kişi adı
Toŋma: kişi adı
sinŋ: bkŋz; siŋ
kösençig: arzu edilen, temenni edilen, istenen
küsüş: arzu, dilek, istek, temenni, bkŋz; küşüş
ögüç: annecik
sukavati: Budistlerin batı cenneti
uma: anne
Nom-kulu: özel ad
uzik nom: mukaddes kanun
nukut: nohut
körüm: rüya, düş, görünüş, nazar noktası noktai nazar, bakış, fal
Tulış: etnonim ve rütbe
Türgiş: Türgeş, etnonim
nöker: maiyet, bkŋz; nökür
nökür: mensubiyet, mensub olma
Kançanprbi: Bodisatvalardan birinin adı
kiŋren-: mırıldanmak
kün teŋri: bir ilah, güneş tanrısı
Kıŋrul: kişi adı
koŋrağı: çan (Azeri 'zil')
koŋrul-: sallanmak, kanrılmak
Kutluğ Teŋri: kişi adı
saŋram: manastır
t (e) ŋri: bkŋz; tŋri, tanrı
t (e) ŋriçi: tanrıya hizmet eden
teŋrili: tanrılı
teŋrilig: tanrılı, semavi, ilahi, dindar, mümin
teŋrilik: mabet, tapınak, ibadet yeri
teŋritem: bkŋz; teŋridem
tıŋrağ: pençe, tırnak, bkŋz; tırŋak
tŋri: Allah, tanrı, ruh, put, gök, sevketli, haşmetli, bkŋz; teŋri
Tŋriken: rütbe, kişi adı
tŋrilik: bkŋz; teŋrilik
anta kin: ondan sonra
burunsuz: burunsuz
Kiŋsün: kişi adı
küsünsüz: güçsüz, kuvvetsiz
öŋsüz: renksiz
Kara-Soŋsuy: kişi adı
saŋsar: (Sanskritçe samsāra)
Sansar: özel ad
sansartakı: maddi dünyada bulunan
sinsim: susam
Soŋsuy: özel ad
taŋsuk: tatlı, nefis, lezzetli, acaip, kıymetli, değerli
taŋ taŋsuk: tatlı, nefis, leziz
tınsıra-: çaldırmak, yese kapılmak, hissetlenmek
unsuz: tasvipsiz, olmaz, değildir, razı olmadan
Konşi-im: Bodistv, kişi adı
Samunşı: özel ad
yaŋşak: yanlış
tarığ: ekin, ekilmiş saha, darı, hububat, menşe, soy
utpatti: menşe (Sanskritçe)
ant: yemin, and
anta: orada, bkŋz; anda
antsu: kişi adı
anvant: bkŋz; avant
basıntur-: bastırılmak
boyuntruk: bkŋz; boyunduruk
buruntuk: gem
Çasaŋtuz: kişi adı
Nuç: yer adı
nuşadır: nişadır
anudara: (Sanskritçe anuttara)
anun-: hazırlanmak
anuk: hazır
anut-: hazırlatmak
anutul-: hazırlatılmak
Anupadat: bir gölün adı
anurd: bkŋz; anurat
öz konuk: ruh
prmanu: atom
koluŋuçı: dilenci
koŋuz: kurt, böcek
kurt koŋuz: göcek
Saŋun: bkŋz; seŋün, özel ad
Sıŋu: özel ad
könük-: tamamen yanmak
könür-: dağlamak, yakmak
közüŋü: ayna, gözgü
Külüg Seŋün: kişi adı
külüŋü: taşıt, nakliye vasıtası
künük: gümüş
künük suv: gümüş suyu
küsüŋü: ayna, gözgü
öŋü: evvelki, önceki
Öŋü: kişi adı
öŋüki: başka, sair
önüş: yükseliş, çıkış
önüşlüg: yükselinecek, çıkılacak olan
Kaymış Seŋün: kişi adı
Boyla: bkŋz; Buyla, rütbe, unvan
İrken: bir ünvandır
Toŋa: kişi adı, rütbe, ünvan
yarğan: bir ünvan, bkŋz; yarkan
könyek: bkŋz; könek
kanya: (Sanskritçe kanyā), bir yıldızın adı
kanyu: hangi, kim
Tonyukuk: Tukiyu devleti vezirlerinden
buyan: (Sanskritçe punya), sevap, iyi amel, kut
kerti: (Sanskritçe krta), yapılmış, suni, dünyevi
yapağ: uzuv, bkŋz; yapığ, yapı, bünye
yirtinçü: dünya, alem, kainat
yirtinçülüg: dünyevi, profan, dünya ile ilgili
tobık: topuk
Tobula: kişi adı
sürçi: boyacı, çoban
İl Koça: kişi adı
Satoda: kişi adı
sodaka: (Sanskritçe) sulu
tod: tam, dolu, kıymetsiz, kötü, sefil, ucuz, bkŋz; tot
toda-: bkŋz; totamak
Yog: (Sanskritçe Yoga), bir şastranın adı, bkŋz; Yoga
oğuş: kabile, soy sop, aile, klan, nesil
oğuşluğ: kabileye, soya mensup
Oğuz: özel ad
oğuz: ilk süt, ağız
örtür-: sürdürmek (tohum ve nebat), karmak, yükseltmek
psak: (Toharca çelenk)
tana: tohum, tane, susam
urugini: (Sanskritçe rohini), bir yıldız adı
uruğ: nesil, kuşak, soy, torunlar, tohum, ekin
Toinak: kişi adı
toy: bayram, toy, bkŋz; toi, şehir, karargah
Toyınak: bkŋz; Toin ak
ok: ok, edat
okı-: okumak, çağırmak, davet etmek
okış-: birbirini davet etmek, birbirini çağırmak
oklat-: paylaşmak
okunç: çağrı, davet, çağırma
okus: bkŋz; oğus
okusluğ: bkŋz; oğuşluğ
Kara-Okuy: kişi adı
soklan-: arzu ve iştiyak duymak, özlemek
ol: bu, bu
olar: onlar
olur: sap, gövde
olur-: oturmak
olurtaçı: oturan
olursuk: oturuş, oturma
om: (Sanskritçe om)
Omar: özel ad
Soma: özel ad
Somaçı: özel ad
tomur-: kan'la birlikte 'kan akmak'
yomuz: bkŋz; yamız, kasık
yara: omuz
on: on
ona: işte, bak
onar: onar
oŋ: sağ, batı yön
oŋa: dayanıklı, metin
oŋar-: onarmak, iyileştirmek, iyi ve sağlam yapmak
oŋaru: sağa doğru
oŋay: kolay
konak: darı
koŋa: ikamet yeri, konut, konak
kon-: konmak, gecelemek, geceyi bir yerde geçirmek
oot: ot, ateş
ootun: küstah
booş: boş
kool: bkŋz; kol
toon: bkŋz; ton
toosın: bkŋz; tosun
tooz: bkŋz; toz
toozun: bkŋz; tosun
kop: çok, hep, bol
kopçır: bir vergi nevi
kop-: kalkmak
top: top yekun, bütün, hep
topolu: toplu, birarada
toprak: toprak
kalançı: kalan vergisini toplayan memur
orğak: orak
orın: bkŋz; orun
ornak: yer mahal
ornan-: kanmak, nazil olmak, sağlam olmak, yerleşmek
Orsulay: özel ad
orta: orta
ortu: bkŋz; ordu, orta
ortun: ortanca
ortuk: ada, ortak
ortukluğ: ortaklaşa, ortaklık, arkadaş
orunçak: emanet
Orus: özel ad
orlan-: var olmak
bor: şarap
Boran: kişi adı
osğurdaçı: bkŋz; oskurdaçı
os-: bkŋz; ozmak
oskuç: kasap çırağı
Oskur-: bkŋz; Ozğurmak
osuğ: yol, tarz, usül, nevi
osul-: biçilmek
osuş-: perişan olmak, darmadağın olmak
bos-: bkŋz; bozmak
boskun-: bkŋz; boşğunmak
tosu: bkŋz; tusu
Yosmut: kişi adı
yosun: nizam, düzen, usul, kanun, kaide
bosunç: talimat
prişti: melek, ferişte, apostol
oşadıkı: gerekli, gereken, lüzumlu, münasip
oşğançula-: aldatmak
oşu: işbu, o
oşul: işbu, o
oşukluğ: benzer, misillü
boş: boş, serbest
boşğun-: öğrenmek, okumak
boşğur-: öğretmek, okutmak, ders vermek, talim etmek
boşğut: bkŋz; boşkut
boşğut-: öğretmek, okutmak
boşkut: okuma, öğrenme, ders
boşuğ yarlık: azat yarlığı
boşun-: boşanmak, serbest olmak, azat olmak, tövbe etmek, kusurunu açıklamak
boşur-: bkŋz; boşğurmak
Kançanakoşi: Bodisatvalardan birinin adı
koş-: koşmak, bağlamak, ayırmak, karıştırmak
koşukluğ: koşulu, koşulacak olan, koşulmak
koşul-: koşulmak
toş başı: göl
toşğur-: baskın yapmak, bkŋz; tuşkurmak
toşkur-: doldurmak
ot: ateş, ot
ota-: tedavi etmek
otla-: tedavi etmek, bakmak
otra: orta
otru: bkŋz; ötrü
otruğ: ada
otsuz: ilaçsız
otun: küstah
otuŋ: odun
oturuğ: bkŋz; otruğ
ot yığaç: ot ve ağaç
otuz: otuz
otuzar: otuzar
kotdurup al-: ele geçirmek, almak
kotı: bkŋz; kodı
Kotsu: kişi adı
kotur: bkŋz; kodur, uyuz, kotur
sotup: bkŋz; stup
tot: bütün, hep, tekmil
ovusuz: bkŋz; uvusuz
ovut: bkŋz; uvut
ovutsuz: bkŋz; uvutsuz
kovla-: kovalamak, bkŋz; koğalamak
kovuk: kovuk, içi boş
kovuşa-: düzlemek
sovuk: soğuk
tovrı: bkŋz; tuurı
yazı: ova, düz yer
ketkire: sürüklenerek, kovalanarak
ketkir-: kovmak, kovalamak, atmak
könek: kova
köprüğ: bkŋz; kovrüg, köprü
kuvla-: kovalamak, takip etmek
oy: kamış, saz, oyuk, çukur
oyna-: oynamak
oyun: oyun
Barça Toyın: erkek adı
boy: boya, renk
boyın: bkŋz; boyun
Boyu Kıra: yer adı
Kan Toyın: erkek adı
Kara Toyın: kişi adı
koy: koyun
koyn: bkŋz; koyın
koyun: koyun, kolaltı
Soyan: kişi adı
Soyar: kişi adı
soyun savınçı: rehin, (hukuk deyimidir)
Toyın: kişi adı
toyun: bkŋz; toyın
tekler-: oymak
ozğulug: kurtulacak
ozğur-: kurtarmak
oz-: kurtulmak, halas olmak, uzaklaşmak
ozkur-: bkŋz; ozğurmak, kurtarmak
bozağu: buzağı
boz-: bkŋz; buzmak, bozmak
kozı: kuzu
sozak: köy
toz: toz, kayın ağacı
tozğak: çiçek tozu
toz-: bitirmek, çıkmak, yükselmek
yozak: kilit
artak: bozuk, yıkık, harap, boğulmuş
artat-: bozmak, harap etmek
buz-: bozmak, kırmak, parçalamak
buzul-: bozulmak
töbü: tepe, zirve, üst, bkŋz; töpü
töbün: başaşağı, tepesi ile
töbüre: aşağı, başaşağı
kurt: böcek, kurt, peynir
öteg: ödev
kötük/g: bkŋz; ködük, iş
küşi: yakılan kokulu nesne, misk, ödağacı, günlük
ötür-: bkŋz; ödürmek
töleç: tazminat, ödenek, 'gratis'
töle-: tediye etmek, ödemek
ögük: çok sevimli, cana yakın, can
kuştr: öğretmen
urı: öğul, genç, delikanlı
sav: söz, haber, şöhret
yol: yol, seyahat, gezi, şöhret, ün, kut
ökek: bkŋz; ögek, hatırlatan
öken: bkŋz; ögen
ökli-: büyümek, çoğalmak, cesametlenmek
öklit-: büyütmek, artırmak
ökök: bkŋz; ögök
ökü-: anlamak
ökünç: nedamet, pişmanlık
ökün-: nedamet etmek, pişman olmak
öküs: bkŋz; öküş
Öküş Kara: erkek adı
öküz: öküz
öl: yaşlık, rütübet, ıslaklık
öleŋ: sulak yer, bataklık arazi, yaş, rutubetli
öl-: ölmek, ölme
ölüm: ölüm
ölürgü: öldürme
ölürgüçi: kanlı, katil
ölür-: öldürmek
ölürt-: öldürtmek
ölüt: katletmek, öldürme
ölütçi: kanlı, katil
söl: usare, et özü
Tölek: kişi adı
tölük: dalma, heyecan, süzme, bakma, seyretme huşü, kuvvet, güç
öm: iç don
ömen: bkŋz; örmen
kömen: hayal, aldanma, büyü, sihir
basut: yardım, kömek
üm: iç donu, bkŋz; öm
yaş: yaş, taze, yeşil, ot, ömür, göz yaşı, yaş, sin, zarar, ziyan
yaşlağ: yaşlı, ömürlü, ihtiyar
öne-: yükselmek
öŋi: artık, hernevi, çeşitli, başka başka, farklı
ön-: çıkmak, yükselmek, yaymak, türemek
öntür-: göndertmek, uzaklaştırmak
öpel-: yanmak, alevlenmek, parlamak
öpiş-: öpüşmek
öpüp: bir cins kuş
köpig: bkŋz; köpüğ, köpüg
köpüg: köpük
töpö: tepe, bkŋz; töpü
töpü: tepe, bkŋz; töpö
kövrüğ: davul, köprü
örgün: bkŋz; örgin
örgüt: daima, her vakit
öri: yüksek, vakur
örit-: yükseltmek, beslemek
örki: yüce yüksek, ali
örled-: bkŋz; örletmek
örletiş-: kızışmış olmak
ört: yanık, alev, ateş, nar
örte-: tutuşturmak, yakmak
örten: alev, ateş
örten-: alevlenmek, kavurulmak, yanmak, kederlenmek
örtgü: bkŋz; örtü
örtkü: bkŋz; örtgü
örtlüg: ateşli, alevli
örtlük: bkŋz; örtlüg
ört-: örtmek, kapamak
örtük: örtük
örtül-: örtülmüş olmak
örtün-: örtünmek
örtünteg: bir çeşit ilaç
örü: yukarı, dik
örüki: yüce, yüksekteki, ali
örük uzatı: devamlı, sürekli, durmadan
örüŋ: açık renkli, beyazımsı
örüş: çıkış, yükseliş
ös: bkŋz; öz
ösen: iç, bir şeyin iç kısmı, deruni, özek
ösür-: kabartmak, şişirtmek
kös: köz
köse-: arzu etmek, dilemek
kösün-: bkŋz; közünmek
kösüş: dilek, istek, arzu
sakı-: beslemek, ciddi olmak, bir şeye itina göstermek, bakmak
taplağ: rıza gösterme, muvakafat etme, kabul etme, peki demek
yarat-: yaratmak, vücuda getirmek, tanzim etmek, düzene koymak, yeniden gözden geçirmek, süslemek, beğendirmek, kendisini göstermek (hukuk), teşvik etmek, gayret etmek
köşit-: kapatmak, örtmek
Töş başı: bataklık, gölün derin yeri
ötek: bkŋz; öteg
ötgürü sat-: aldığını başkasına satmak
ötkürü: bkŋz; ötgürü
ötmiş: kurban, kurbanlık
ötrü: ötrü, için, sonra, o zaman
öttrü: bkŋz; ötrü
ötüg: bkŋz; ötük, dilek, dua, istida, sual
Ötügen: yer adı
ötürü: bkŋz; ötrü
ötürük: ötürük, ishal
ötdük: tarih
İl Ötüken: Kral adı, kişi adı
köti-: yükselmek, çıkmak, kalkmak, binmek
kötki: dağlık arazi, yayla
Kötüt: kişi adı
tötkel: bkŋz; tükel
ögüt-: övmek
ögürt-: kendisini övdürmek
sınlığ: vücuda ait olan, gövde ile ilgili
sök-: sökmek, koparmak, azarlamak, sövmek, baygınlık geçirmek
öy: ev
öyür: darı
öyürken: bir ilaç adı
köy-: yanmak, kavrulmak
köyir-: yakmak
köytril-: yakılmak
köyük: yanmış, kavrulmuş
köyür-: yakmak, yakmış olmak
küy-: yanmak, köymek
sa-: saymak, söylemek
sarsı-: azarlamak, söylenmek
savıkla-: söylemek
öz: dere, kendi, özü, vücut
öze: üstte, üstünde, üzerinde, yukarıda
özek: küçük dere
özele-: üste çıkmak, yükselmek
özelen-: yükselmek
özelik: yükseklik
özen: içerlek, tam orta, en içeride bulunan, ilk, öz
özüm: kendim, özüm
özüt: ruh, can
köze-: istemek, arzulamak
Közemiş: kişi adı
közkiş-: karşılıklı görmek
köznek: akis
közün: güç, kuvvet
Közünçi: kişi adı
közüş: istek, arzu, dilek
söz: söz, emir, buyruk
sözlegülüg: söylenecek olan
sözle-: söylemek, konuşmak, nutuk, konuşma
tapçalığ: kirli, pis, pislenmiş
tapçasız: kirli
erüş: pek çok, sayısız, hesapsız
tarmak: pençe, tırmık, dağıtmak, parçalamak
tarmaklağ: pençeli
tünlük: pencere
bekürü: sağlam, kuvvetli, berk, pek
tüpger-: esaslı araştırmak, zirveye ulaşmak, bkŋz; tüpgermek
tüpker-: esasını araştırmak, zirveye ulaşmak, bkŋz; tüpgermek
Yapğun: kişi adı
seŋir: dağın eteği, yamacı, ön cephesi
sizik: kuşku, şüphe, tıraş
siziklig: şüpheli
sizin-: şüphelenmek
sapığ: sıra, dizi
tapığ: tapma, perestiş etme, hürmet
tapındur-: taptırmak
tapın-: tapınmak, perestiş, hürmet etmek
tapık: ön, cihet önde olan
tapış-: buluşmak, karşılaşmak, rastlaşmak
turpı: dana
yapı: kabuk
yapığ: yapı, bağlayan, rapteden
yapın-: hazırlanmak, kapanmak
yapırğaklağ: yapraklı
yapırkak: yaprak
yapış-: yapışmak
bakırlağ: bakırdan yapılmış
çatık: birbirine kenetlenmış, yapışık
kerpiç: kerpiç
kirpi: kirpi
kirpik: kirpik
katur-: pişman olmak
sapla-: saplamak, ok germek
taplağusuz: sadakatsız
tüplüg: köklü, dipli, esasız, dipsiz
Yaplış: kişi adı
kün: güneş, gün, zaman, vakit, güney, lakaplarda kullanılır, millet, kavim
Tapmış: kişi adı
kırk-: tıraş etmek, kırpmak, hayvan tüyünü kesmek
suvsuş: içki, içilecek şey, bir şeyin üzerine su serpme
tapağ: tapma, hürmet, hizmet, tapınma
tap-: tapmak perestiş etmek, bulmak, elde etmek
tegin-: duçar olmak, kabullenmek, yaklaşmak, erişmek, sevkolunmak, saygı ve hürmetle bir şeyi yapmak, ceht ve say etmek, hissetmek, (Sanskritçe Vedanā)
tültür-: çarpmak, vurmak
üzeliksiz: kesilmeden, kopmadan, aralıksız, sürekli, daimi
üzkel-: kırılmak, kopmak
üzül-: kesilmek, kopmak, sonu gelmek
türtüŋü: merhem, pomada
türtün-: merhem sürünmek, pomada sürmek
prayŋa: (Sanskritçe) bilgin, alim, düşünür
pret: (Tah.preta), şeytan
prit: (Sanskritçe preta), hayal
pryan: çile yeri, çilegah, inziva
tuprak: toprak
kunçuy: prenses
tuturkan: prinç
tüki: prinç, prinç kabuğu, soyulmuş darı
supsup: bir çiçek türü
tapsız: isteksiz, arzusuz
yapsın-: birleşmek, yapışmak
yapsur-: bkŋz; yapşurmak
kamuğ: bkŋz; kamağ, hepsi, tamamıyla
kolusuz: vakitsiz, zamansız, sayısız, hesapsız
sakışsız: düşüncesiz, sayısız, hesapsız
turu: bütünü, hepsi, tamamı, yeküni
tutsuk-: hapsedilmek
tutultur-: tutulmak, hapsettirilmek
tüze: bütünü, hepsi, tamamı
yapşur-: yapıştırmak, bkŋz; yapsurmak
yapşın-: yapışmak
ptr: (Sanskritçe pattra), varak
tamalaptr: (Sanskritçe tamālapattra), güzel kokulu bir bitki yaprağı
erttür-: yaptırtmak, tamamlatmak, geçirtmek
İl Tutmuş: lakaptır (hakanlar için)
küsemiş: lakaptır
tutayağ/k: zaptetme, bkŋz; tutyak
tutku: kapama, zaptetme
ula-: bağlamak, raptetmek
purkan: bkŋz; burhan
pusar: Botisatva
puş: (Sanskritçe) bir yıldızın adı
puşi: sadaka, zekat
puşiçi: dilenci
puşrul-: kızdırılmak, hiddetlendirilmek
puşurkan-: endişelenmek, kaygulanmak, kızmak
puşuşluğ: kederli, kaygulu, meyus, gamlı
putığ: bkŋz; butığ
supurğan: stupa, bkŋz; stup
tapuğ: bkŋz; tapığ
tapuk: bkŋz; tapık
pür: bür
püs-: gizlenmek, saklanmak
püt-: bitmek
pütün: bütün
pütür-: bkŋz; bütürmek
Tüpüt: Tibet
yüpün: kırmızı
karba: ilaçlık bir bitki türü
Terbi-İnal: erkek adı
Torbalığ: kişi adı
Turbay: kişi adı
barın-: boşanmak, serbestlenmek
birin birin: teker teker, birbir
buşı: sadaka, kurbanlık
kergü: kabarcık
karh: burc
kavuk: kabarcık
savçı: haberci, geveze, zevzek, boşuboşuna konuşan
tıŋçı: haberci, bkŋz; tiŋçi
tirkiş: kervan, haberci
yuŋlaklığ: kullanılacak, harcanacak olan, bkŋz; yoŋlaklığ
yuŋla-: kullanmak, harcamak, yararlanmak, istifade etmek
barçın: bir kumaş türü
korçu: inançsız
torçı: ağla avlanan, avda ağ kullanan
Turçı: kişi adı
Türçi: kişi adı
türçimeksiz: türemeden, zuhur etmeden
yirçi suvçi: denizci kılavuz
yirçile-: yol göstermek, kılavuzluk etmek
tardıl-: bkŋz; tartılmak
tard-: bkŋz; tartmak
Tarduş: bir rütbe
urdun: Örs
yirdeki: yerdeki
yorğurd: yoğurt
İl İnanç Tirek: kişi adı
İşire: kişi adı
kerek: bkŋz; kergek
kerekü: çadır
toğu: örf, adet, gelenek, düzen, nizam, kanun
toku: töre, tören, merasım, adet, örf
tokuluğ: kanuni, nizami, örfe uygun, bkŋz; tokulığ
yaŋ: örf, gelenek, usul, nizam, ölçü, miktar, hacim, parlaklık, fil
yaŋlığ: ...kabilinden, çeşit, vücuda gelmiş, türemiş, örfe uygun
üsük: harf
İl Türgüg: retbedir
kerge-: eksik olmak
kerget-: sınırlandırmak, hudutlandırmak, yoksun kılmak
Kergü: Seleŋa ırmağı yakınlarında bir yer adı, yer adı
körg: bkŋz; körk, güzellik, güzel, görünüş
burğu: bkŋz; burku
karğa: karga
karğat-: beddua ettirmek
katırğan: akasyaya benzer bir ağaç
kırğın: karavaş, cariye
kurğağ: kara, toprak, bkŋz; kurğak
kurğak: bkŋz; kurğağ
kurğan: kurgan, kale
kurğur-: gerçekleştirmek, azemet satmak, gururlanmak, ululanmak, büyüklenmek
sarğan: sert, karı ve çorak arazide yetişen kuru bitki
sarğar-: sararmak
suburğan: bkŋz; sın, mezar, cenaze alayı
Yalturğan: yer adı
yarğu: karar, hüküm
karış: mekik ipliği, atkı, arğaç, dokumacılıkta enine atılan iplik
burhan: bkŋz; burkan
İsig Tarhan: kişi adı
İt Tarhan: kişi adı
tarhan: bkŋz; tarkan
trhan: bkŋz; tarkan
biri: biri, sağ, güney
Barkan: yer adı, yer adı
barku: bkŋz; burku
berkir-: berkitmek, sağlamlaştırmak
birke: bkŋz; berke
birkerü: bkŋz; birgerü
Burkay: kişi adı
burkı: buruşuk
buşurkan-: bkŋz; boşurkanmak
butarla-: parçalamak, yırtmak, parça parça etmek
çarla-: çağırmak
erli: erli, erkekli
kirlen-: kirlenmek
kirlig: kirli
kürle-: aldatmak, tavlamak
kurla: sıra
tarlağu: tarla
temirlig: demirli, demirden
terlik: terlik
tirle-: derlemek, toplamak
barm: (Sanskritçe param)
Kün Bermiş: kişi adı
Kanturmış: erkek adı
Kanturmuş İnal: erkek adı
kırmalaş-: parçalamak, kırmak
Kız Turmış: kız adı, kişi adı
Kutluğ Turmış: kişi adı
surma: şarap, bkŋz; sürme
sürme: şarap
erŋek: parmak
tarnı: bkŋz; darnı
tırnak: tırnak
tırŋak: tırnak
uluğ erŋek: baş parmak
arna-: adamak
arnaş: niyet
suk: bkŋz; şük, ihtiras, heves, istek, iştiyak, özlem, bkŋz; erŋek, işaret parmağı
Yaroğlu: kişi adı
koruş: (Sanskritçe kroşa), çağırma
şuruti: (Sanskritçe şrota), işitilmiş, duyulmuş
uran: parola
arpa: arpa
Karpak: kişi adı
sarp: sarp, sert
yarp: sağlam, güçlü, kuvvetli
kurı: bayram toplantısı, garp, batı
soğuş-: çarpışmak
tokıtıl-: vurulmak, çarpılmak, sallanmak
turma: turp
tütüş: savaş, harp, mücadele
tütüş-: tutuşmak, savaşmak, çarpışmak, bkŋz; tüdüşmek
urunt: kavga, çarpışma
kata: defa, kez, kerre, sıra
suv: su, merrih, su yıldızı
süzük: duru, berrak, temiz
tetrüm: aydın, açık, berrak, zeki, akıllı, anlayışlı
torul-: durulmak, süzülmek, berraklaşmak
türgün: kez, kerre, defa, yol
arslan: arslan
Arslan: kişi adı
Bars buka: erkek adı, kişi adı
bursuŋ: bkŋz; purseŋ, bkŋz; bursaŋ
erslan: bkŋz; arslan
Kerskiç: kişi adı
k (i) kirsiz: lekesiz
kirsiz: arı, temiz pak, kirsiz
korsuz: ziyansız, zararsız
sarsağ: sarsak, kötü, kaba
sarsığ: kaba, kötü, sarsak, çürük
ters: ters, yanlış
Kerşin: kişi adı
karşı: karşı taraf, saray, kavga
karşu: bkŋz; karşı
kurşa-: sarmak, kuşatmak, çevirmek
kurşadıl-: kuşatılmak, çevrilmek
kurşan-: kuşaklanmak, kuşak sarmak
Urşı: kişi adı
satığlığ: satılacak olan herşey
sokuş-: saplanmak, tutuşmak, rastlaşmak, karşılaşmak, vuruşmak
telük: erzak, yenilecek herşey
art: arka, yardım, dağ geçidi
artı: bkŋz; arıtı
Artı ınal: kişi adı
art-: artmak, çoğalmak
bart-: kırmak, bkŋz; birtmek, bkŋz; bırtmak
bertin-: yaralanmak, kendisini yaralamak
bert-: bkŋz; birtmek, kırmak, parçalamak
bertük: sakat, parçalanmış
birt: bir vergi türü
birt-: bkŋz; bertmek, kırmak, parçalamak, yaralamak
Aruğ: kişi adı
baru: beri, dolayı
buyruk: buyruk [rütbe]
çaruk: çarık
berü: beri, beriye
erük: erik
irü: işaret, alamet
kirü: geri
Körü: kişi adı
körük/g: güzel, güzellik, görüş, casus
baram: bkŋz; barım, mal, servet, varlık
buryuk: bkŋz; buyruk, buyruk
Surya: kişi adı
turya: (Sanskritçe) dörtte bir, çeyrek
Yırya: kişi adı
tutğak: inilti, nale, feryad
barz: bkŋz; bars
tarzul: bkŋz; trizul
trzul: drzul
küse-: istemek, arzu etmek
küsençig: istenilen, arzu edilen
küsenç: istek, arzu, dileme, dilek
kın-: istemek, arzu etmek
tap: arzu, istek
usbad: ilaç yerine kullanılan bir bitki adı
tözügü: tamamıyla, büsbütün
tözün: asil soydan, asaletli, kamilen, büsbütün
yime tügel: tamamıyla, büsbütün
yintem: tamamıyla, büsbütün, tümü ile, sabit
tirazuk: (Farsça tarāzūk), terazi
Suvasdık-si: bir manastırın adı
üsdün: bkŋz; üstün
üsdürti: bkŋz; üstürti
yasduk: bkŋz; yastuk
tanukla-: tanıklık etmek, şehadet etmek, tevsik etmek, tasdik etmek
üstün: üstte, yukarıda, bkŋz; üsdün ~ üzdün
Sekinç Kara: özel ad
sekiz: sekiz
sekizinç: sekizinci
sekizon: seksen
Selene: selenga ırmağı
Seli: özel ad
semek: orman
Semiçe: özel ad
Semiş: özel ad
semiz: semiz
sen: sen (zamir)
Seŋe: kişi adı
Seŋüi Tutuŋ: kişi adı
seŋün: (Çince) general
seŋig: ait, ek olarak, ilave olarak
Seŋün: memuriyet adı, derecesi
seniŋ: senin
sergür-: bkŋz; serkürmek
serid-: eritmek, erimek
seril-: serilmek, artmak, heyecanlanmak, metinleşmek, sona ermek, durmak
serke: bkŋz; sirke
tasğaru: bkŋz; taşkaru
kızğaç: bkŋz; kısğaç
kınlık: hapishane, ceza evi
sıçık: arka, kıç, göt
sığış: bkŋz; sıkış
sığun: erkek geyik, meral
Sık: özel ad
sık: arazi ölçüsü
sıka-: sıklaştırmak, kalınlaştırmak
Sıkap: yer adı, ırmak adı
sıkığ: korku, sıkıntı
sıkıl-: sıkılmak, eziyet çekmek
sıkın-: sığınmak, ezilmek
sıkış: keder, kaygu, sıkışma, sıkışıklık, sıkıntı
sıkışlığ: kederli, sıkılmış olma
sık-: sıkmak
sıkur-: toplamak
Sıla: kişi adı
Sılaŋ: kadın adı
Sılavantı: kişi adı
Sılığ: özel ad
sıl-: silmek
sı-: kırmak, sındırmak
si: bkŋz; Kaŋ-şi
sidir: bkŋz; satır
sigiri-: seğirtmek, koşmak, yutmak
sigirt-: yakalamak, durdurmak, yutulmak
sik: sidik
silig/k: arı, temiz, pak, bakire
sili-: arınmak, temizlenmek, paklanmak
Silü: özel ad
sim: sınır, hudut
simek: orman, bkŋz; semek
sin: sen (zamir), bir ölçü çeşidi
Sinan: erkek adı
siŋ: kiler
siŋar: gök ciheti ve yönleri
siŋek: sinek
siŋir: sinir
siŋirke: ufak sinirler
siŋir-: yutmak, hazmetmek, sindirmek
siŋ-: damlamak
siŋük: bkŋz; süŋük
sini: seni (zamir)
Sini er: erkek adı
sintin: senden
siri: bir ilaç adı
Siristi: özel ad
küskü: sıçan, fare
kaskuk: bkŋz; kazkuk
süskün: arka
taskaru: bkŋz; taşkara
uskada: ilaç olarak kullanılan bir bitki
uskun: sarımsak
üsk: ön
yaskağ: yassı, düz
kislegüg: bkŋz; kizlegülük
Kasmık: kişi adı
basın-: basmak, ezmek
bas-: yaymak, basmak, kazanmak, yenmek
kar: kar, omuz, kolun üst kısmı
karkanadus: kusma hastalığı
kavır-: basmak, tazyik etmek, kavurmak
kunçı: nazari olarak bilinen ayın bir kısmı
kus-: kusmak
kuz-: bkŋz; kusmak
sokun-: kesmek
sn: bkŋz; sen
basn: bundan başka, sonra, onun arkadasından, arka
üsne-: bkŋz; üznemek
sıŋar: burç mıntıkası, yön, taraf, bir nesnenin yarısı
tütsüg (k): tütsü, tütsülenen nesne
so: zincir, (Çince so)
soğan: soğan
soğığ: soğuk
soğık: bkŋz; soğığ, soğuk
soğık suv: soğuk su
soğı-: soğumak
soğıt-: soğutmak
soğur-: elde etmek, soğuklamak
soklun-: körleşmek, kör olmak
sol: sol, şark, doğu
sola-: bir yerde olmak, bulunmak, zincire vurmak, bağlamak
solat-: getirtmek, kapatmak
sol-: kaybolmak
Soltan: soldan
soŋ: son, sonra
sorul-: sorulmak, emilmek
sögül-: kızartılmak
sö: bkŋz; söki, vakit, zaman
sögüş şiş: kebap şiş
sögüt: sögüt ağacı
söki: önceki, evvelki, eskiden
söklünçü: kızartma, kebap
sökü-: diz çözmek
sökür-: dize getirmek, çöktürmek
söküt-: diz çöktürmek
sön: uzun müddet, zaman
söŋi: süŋü, bkŋz; söŋü
söŋü: bkŋz; söŋi ~ söŋgü
Söŋü: özel ad
söŋük: kemik, süŋük
söŋüklüg: kemikli, kemikten itibaren olan, bkŋz; süŋüklüg
söŋüşgeli: savaşa katılmış
söŋüş-: harbetmek, savaşmak
sön-: sönmek, dinmek, kendinden geçmek
söntür-: söndürmek, bir yana atmak, bertaraf etmek
sönük: sönük, kuvvetten düşmüş
sözletil-: konuşturulmak, söyletilmek
sözlüg: sözlü
yas söŋük: kemik (yassı, düz)
Salaspati: özel ad
kisre: sonra
kisreki: sonraki
tuy-: duymak, tanımak, hissetmek
tuyun-: anlamak, hissetmek
stabiş: bkŋz; satabiş
stır: bkŋz; satır
Stravst: yer adı, şehir adı
Strayastriş: (Sanskritçe trayastrimsat), semalardan birinin adı
stup: stupa, bkŋz; supurğan
Şravst: Stravastra şehrinin adı
üst: üst
üstel-: çoğaltılmak, artırılmak, büyütülmek
üste-: artırmak, çoğaltmak
üstürti: üstten, yukarıdan, bkŋz; üstürdi
yastuk: bir çeşit sikke, para
su: bkŋz; suv, su, Çince 'sağ ve salim', bkŋz; esen
suçul-: çekilmek, bkŋz; suçulunmak, soyunmak
Sudasumi: kral Sutasoma'nın adı
Sudazumi: bkŋz; Sudasumi
sudur: (Sanskritçe sūtra), budanın vaizi
suğ: bkŋz; suk, su
suğul-: kurumak, suyunu çekmek
suğun: geyik, bkŋz; sığun
sui: bkŋz; tsui
sulanı: bir bitki
Sumir: (Sanskritçe sumeru), bir dağın adı, bkŋz; Sumır
suna yat-: uzanmak, gerilmek
sunçuk: yastık (?)
Sundari: kişi adı
sun-: sunmak, yaymak, kendine doğru çekmek
Supatra: özel ad
sukar: bir bitki türü
sukığ: parmak teması, dokunması
suk-: sokmak
Surı: erkek adı
sur-: yüzmek, soymak (deri için), sormak
Susaŋ: kişi adı
Sutmak: kişi adı
sü: ordu, asker, bkŋz; süü
süçüg: tatlı şarap, bkŋz; süçük, tatlı, lezzetli
süçük: bkŋz; süçüg
süçülüg: gerileyen, geride kalan
südür-: çekmek, bkŋz; südremek
südük: sidik
sük: bkŋz; şük, sakin
süklün-: kızartılmak
süksümir: bkŋz; suksumur
Sükü Öken: bir nehrin adı
sül: irin, cerehat
süle-: asker çekmek, ordu sevketmek, sefere çıkmak
sülüg: ordulu, ordusu olan
süŋük: kemik, bkŋz; söŋük
süŋüklüg: kemikten ibaret olan, bkŋz; söŋüklük
sür-: gütmek, otlatmak, sarketmek, sürmek
sürt-: sürtmek
sürüg: sürü
süs-: bkŋz; süzmek
süt: süt
süü: bkŋz; sü, ordu, asker
süü başı: kumandan
süüle-: bkŋz; sülemek
süvri: sivri
süzkü: süzgü, süzgeç
süz-: süzmek, temizlemek
süzüg: süzülmüş, filtre edilmiş, bkŋz; süzlük
süzül-: süzülmek, temizlenmek
sva: (Sanskritçe svāhā), bkŋz; svaha
svinç: bkŋz; sevinç
svin-: bkŋz; sevinmek
sv-: bkŋz; sevmek
örü tur-: dik durmak, isyan etmek
uşbu: işbu
Başçı: kişi adı
kuşçı: kuşçu
turuşçı: savaşçı, davacı
uruŋu: savaşçı, muharip
taşdın sınar: dışarıda
taştın: dışarıdan, bkŋz; taşdın
Kişe-: bağlamak, bendetmek
kişen: uçkur
tüşe-: rüya görmek, düş görmek
Üşe: kişi adı
üşet-: ufalamak, parçalamak
yavaş: yumuşak huylu, sakin, halim, müşfik, rahim
taşğar-: bkŋz; taşkarmak, uzaklaştırmak
taşğaru: dışarı, bkŋz; taşkaru
yavışğu: yaprak, çelenk
taşkaru: dışarı, taşra, bkŋz; taşğaru
tavşan: tavşan, bkŋz; tavışkan, bkŋz; tavışğan
tuşkur-: bkŋz; toşğurmak
Taşık baş: yer adı
taşık-: taşmak, dışarı çıkmak
taşım: çok
taşır-: teslim etmek, getirmek, taşımak
şirir: (Sanskritçe sarīra)
Şiş: kişi adı
şiş: şiş, kabarık, ur
şiş-: şişmek
İşig: kadın lakabı
kişilen-: evlenmek
şker: bkŋz; şeker
İşkara: kişi adı
taşkar-: uzaklaştırmak, evlendirmek
Yaşkan: kişi adı
başla-: başlamak
başlan-: başlanmak
başlığ: başlı, yaralı
kamışlığ: kamışlı, sazlı
kırtışlığ: güzel yüzlü
kışla-: kışlamak
kışlık: kışlık
terkişlen-: kızmak, kavgaya tutuşmak
tişle-: dişlemek
tüşlüg: semereli, verimli, yemişli
uluşluğ: memlekete ait, memleketle ilgili
Urışlum: bkŋz; Urıslum
Tayışma: kişi adı
yaraşmaz: yakışık almak, yaraşmaz, yakışmaz
bar-: varmak, girmek, ulaşmak
şnük: bkŋz; şenük
tüşnek: ikamet yeri, oturma yeri
yaşna-: yaşamak
şünük: bkŋz; şenük ~ şnük
şor: tuzlu
uluğ aş: ziyafet, toy, şölen
şrir: akıntıya kapılmış olan
yaltrı-: parlamak, ziya neşretmek, ışık vermek
busuşsuz: kedersiz, üzüntüsüz
tavışsız: gürültüsüz, sakin
tüşsüz: neticesiz, semeresiz, sonuçsuz
küşti: ilaç olarak kullanılan bir bitki çeşidi
taştır-: taşırmak, dışarıya çıkarmak
vrişti: bkŋz; ferişti, melek
yaraştur-: yakıştırmak, faydalı duruma getirmek
Kaşu: yer adı
kaşuk: kaşık
kavışur-: kavuşturmak
kavşur-: birleştirmek, katlamak, bir araya getirmek, kavuşturmak
saşur-: durdurmak, geciktirmek
şük: sakin
külüşüg/k: gülüş
küşüş: bkŋz; küsüş
tüşük: vergi adı
Tüşümen: memuriyet adı
tüşür-: düşürmek, indirmek, sevketmek
tüşütlen-: tahayyül etmek, hayal kurmak, mülahaza etmek
yüleşür-: mukayese etmek, benzetmek, karşılaştırmak
una-: taşvip, etmek, razı olmak, muvafakat etmek, doğru bulmak
Buyla: rütbe
İl Tatğu: rütbedir
kırtış: betbeniz, yüzün rengi, yüz güzeli
Tarkat: bir rütbe
Tigin-üge: kişi adı ve bir rütbedir
Tupa: kabile ve rütbe adı
Tutuk: kişi adı, rütbe
Yavğu: bir rütbe
tutçı: durmadan, arkası kesilmeden, daima, mütemadiyen
yoğurtça: yoğurt gibi
titdiŋ: dağıttın, feda ettin
Tegeli: kişi adı
tegi: akraba, kadar
tegil-: körlenmek, kör edilmek, dokunulmak, kamaştırılmak
tegim: sıra, müddet
tegin: bkŋz; tigin
teginç: vasıl olma, erişme, yetişme
tegirmen: değirmen
tegirmi: değirmi, yuvarlak, çevre
tegiş-: rastlaşmak
teg-: ulaşmak, erişmek, düçar olmak
tegürtür-: ulaştırtmak
kertgünç: bkŋz; kertkünç ~ kirtgünç
kirtgünç: inançlı, imanlı, mutekid
kirtgün-: inanmak, itikad etmek
kirtgür-: inanmak
kitgüsi: giderilmesi gerekli
kertkünç: inançlı, mutekit, imanlı, bkŋz; kirtgünç
kirtkün-: bkŋz; kirtgünmek
körtkür-: bkŋz; körtgürmek
yola-: tesadüf etmek, rastgelmek, karşısına çıkmak, yol göstermek, sevketmek
katğı: sıkı, sağlam, katı, sert
katğuruş-: ses çıkarmak
koltğuçı: dilenci
kurtğar-: kurtarmak
kutğar-: bkŋz; kutkarmak, kurtarmak
satğa-: aşmak
tavratğuçı: tevşik edici
utğurağ: bkŋz; utğurak
yatğu: yatılacak yer
yatğur-: yatırmak, uzatmak
utkurak: bkŋz; utğurak
tı: daima, devamlı, kesiksiz
tıka-: tıkamak
tık-: tıkmak, tıkamak
tıl: bkŋz; til, dil
tılaŋur-: güzel konuşmak, natık olmak, muhakemesi sağlam ve kuvvetli olmak
tıltağ: sebep, mucip
tıltağlığ: sebepli
tılta-: itiraz etmek, sebep olmak
tıltak: bkŋz; tıltağ
tıŋ: seda, ses perdesi, ton
Tıŋız: kişi adı
tıŋla-: dinlemek, kulak asmak
tın-: dinlenmek
tıntur-: dinlendirmek
tıt: çam ağacı
tıtığ: bkŋz; tıdığ
tid-: bkŋz; titmek
Tigin: kişi adı
tigit: vekil, vezir, prens, nazır
Tigü: kişi adı
tik: dik
tiken: diken
tiki: gürültü, şamata, çoğlama, şarıltı, patırtı
tikisiz: gürültüsüz, patırtısız
tikiş-: itişmek, kalkışmak, vuruşmak
tik-: dikmek
til: dil, söz, nutuk
tilegülük: dileyen, arzu eden, dilenen, istenen
tilek: dilek, arzu, bkŋz; dilik
tilet-: diletmek
tilik: dilek, arzu, bkŋz; tilek
tilkü: tilki
timen-: hazırlanmak
tin: bkŋz; tın, yular
tiŋç: bkŋz; teginç
tire-: desteklemek, diremek
Tirek: kişi adı
tirgin: bkŋz; tirin
tk: bkŋz; tek
kertkün-: bkŋz; kirtkünmek
küntki: bkŋz; künteki
Katkay: kişi adı
kutkar-: kurtarmak
Kutkan: kişi adı
tutkuğ: rehin
ürtkün: harman
kutluğ: kutlu, mesud, uğurlu
Kutluğ: kadın adı
Kutluğ oğul: kişi adı
Kutluğ beg: kişi adı
Kutluğ Buğa: kişi adı
Kutluğ Bürt: kişi adı
Kutluğ Tayak: kişi adı
Kutluğ Toŋa: kişi adı
Salı Kutluğ: erkek adı
uğutla-: mayalamak
tmır: bkŋz; tamır
tmir: bkŋz; temir
kitmen: kazma, bel
Katmış: kişi adı
Satmış: kişi adı
yitmiş: yetmiş (70)
Yitmiş: kişi adı
tŋil-: bkŋz; teŋilmek
toğa: hastalık, sakatlık, kör
toğuz: bkŋz; tokuz
Tok: kişi adı
tok: tok
toka: bkŋz; toğa
Toka: kişi adı
Tokak: kişi adı
toka-: bkŋz; tokımak
tokığa/u: tef tokmağı, davul tokmağı
tokın-: bkŋz; dokunmak
tögü: darı
tökedi: bkŋz; tüketi
Tökel: kişi adı
töketi: bkŋz; tüketi
töklün-: ayrılmak, dökülmek, dökülmüş olmak
tökün-: bkŋz; tükünmek
tör: ön, şeref yeri, şeref makamı
Töredü: kişi adı
törlüg: bkŋz; türlüg
törüçi: kanun yapan, muallim
törülüg: kanuni
törülük: bkŋz; törülüg
törüt-: türetmek
Sutpak: kişi adı
trazuk: bkŋz; tarazuk
trit-: yanmak, yakmak
trizul: (Sanskritçe trisūla), üç dişli, bkŋz; tarzuk ~ drzul
trk: bkŋz; terk
trs: bkŋz; ters
körtrek: daha güzel
katrun-: kuvvetlenmek
tsaŋçı: hazinedar
tsun: resim, vergi, (Çince ts'un), uzunluk ölçüsü
tsuy: günah, suç, kabahat, bkŋz; sui, (Çince tsui)
irtsiz: vergisiz
kün batsıkınaru: güneşin battığı yer, batı
suvatsır: bkŋz; suvatçır
tıtsı: (Çince ti-tsu) talebe, bkŋz; titsi
Tıtsu: kişi adı
titsi: (Çince ti-tsu), şakirt, öğrenci, muallim, öğretmen, bkŋz; tıtsı
tütsülüg: künlüg, günlük
utsuk-: kaybetmek, mağlup olmak
uvutsuz: terbiyesiz, utanmaz
tutşuk-: toplanmak
yitti: yiti, iti, keskin, bkŋz; yiti
yittir-: kaybetmek
tuda-: bkŋz; totamak
tud-: bkŋz; tutmak
tudultur-: bkŋz; tutulturmak
tudunç: haya, utanç
tudun-: bkŋz; tutunmak
tuğ: bayrak, sancak
tuğa: hastalık
tuğlığ: bayraklı, sancaklı
tuğluğa: zırh
tuğ-: doğmak, bkŋz; toğmak
tuğum: doğum
tuğut: güneşin doğması
tul: bkŋz; tol, dul
Tulat: kadın adı
tul-: kapamak
tulkun: bkŋz; tolkuk
tulun: tolun ay, bedir, bkŋz; tlün
tuluŋ: şakak
tuluk: tulum
tumağu: nezle
Tuman: kişi adı
tumanlığ: dumanlı, sisli
tu-: kapamak, tutmak
tumıl-: soğumak, donmak
Tumur: kişi adı
tun-: tıkanmak, kapanmak
tü: saç, kıl, her türlü, çeşitli, türlü türlü, bkŋz; tüü
tüb: bkŋz; tüp
tübençik: tabi olan, uyan
Tübüt: Tibet
tüdüş: bkŋz; tütüş
tüdüş-: bkŋz; tütüşmek
Tüge: kişi adı
tügel: bkŋz; tükel, tam, tamamıyla
tük: tüy, saç, yün, bkŋz; tümen
tükedi: bkŋz; tüketi
tükegü: tükenme
tükel: tam, tamamıyla, iyi bir halde
tüke-: bitmek, tükenmek
tüket-: tüketmek, bitirmek
tüketi: tamamıyla, bkŋz; tükedi, tamam
tüklüg: tamamıyla, tam
tük-: buruşmak, somurtmak
Tükün: kişi adı
tükün-: doldurmak
Tüküz: yer adı
tül: düş, rüya
Tülek: kişi adı
tülit: baş yastığı, yatak takımı
tült: yastık, bkŋz; tülit
tülte-: güzelleştirmek
Tülük: kişi adı
Tümen: kişi adı
tün: gece, karanlık
tünerig: zulmet, karanlık
tüner-: karanlık basmak
tvar: bkŋz; tavar
Tvğaç: bkŋz; Tavğaç, Çin
tvrat-: itmek, dürtmek, tecil etmek
Kumut: Bodisatva'nın adı
tutyağ/k: bkŋz; tutayağ
tutyak: sağlam bağlanmış olmak
tutyak-: varlığa bağlanmak
tützük: bkŋz; tütsük
utzuha-: mağlup olmak, yenilmek
kuva: bkŋz; kua, çiçek
tarağ: bkŋz; tarığ, hububat, ekin
terk: çabucak, çabuk, derhal, alelacele
uşa-: ufalamak, parçalamak
uşak: ufak, küçük
uvşak: ufak
yanlug (k): yanlış, hata, bkŋz; yaŋıluk
tolug: dolu
uğan: tanrı, Allah, bkŋz; oğan
uğuş: bkŋz; ukuş
uğuz: süt (ilk), avuz, ağız
uh-: bkŋz; ukmak
kü-: muhafaza etmek, saklamak, korumak
küzet-: gözetmek, saklamak, muhafaza etmek
sakuş-: birisini himayeye almak, birini koltuğu altına almak, muhafaza etmek
Uyğur: bkŋz; Uiğur, Uygur
ukıt-: anlatmak, öğretmek, bildirmek
uk-: anlamak, öğrenmek, kavramak
ukun-: anlamak, kani olmak, itiraf etmek, kabul etmek
ul: dip, zemin
ulal-: bağlı ve merbut olmak
ulam: daimi, kesiksiz
ular: keklik, bkŋz; olar
ulatı: daha, saire, ilahara, ilaveten, ...den başka
ulığ: sızlanma, uluma
ulı-: ulumak, sızlanmak, yüksek sesle ağlamak
ulış-: sızlaşmak, ağlaşmak, inleşmek
ultuŋ: sütün
uluğ: ulu, büyük, seçkin, asil, seçme
uluğ bay: zengin
ululad-: nakledilmek
ulus: bkŋz; uluş
uluş: memleket, devlet, ülke
umai: doğum sonu, kadın uzvu, rahim, döl yatağı
Umal: kişi adı, kadın adı
Umıçı: kişi adı
umul-: umulmak
umuk: dost, eş, arkadaş
kumut çiçek: isim
tokum: bkŋz; toğum
unıt-: unutmak
Urupadatu: yer adı
karış-: karışmak, düşman kesilmek, mağlup olmak
utuzmaksız: namağlup, yenilmeyen, yenilmez
urla-: bağırmak
urluğ: aile, soy, soysop
ur-: vurmak, dikmek, koymak, tanzim etmek, düzenlemek
urtu: orta
Uru: şeytan adı
uruŋut: bkŋz; uruŋu
uruş: savaş, mücadele
us: akıl
usağ: susuzluk
usamağ: bkŋz; uzamak
usan-: susamak, bkŋz; usmak, bkŋz; uşanmak, inanmak, itimad etmek
us-: susuzlamak
Usuk: kişi adı
usun: bkŋz; uzun
Usun: kişi adı
busan-: umutsuzluğa düşmek, meyus olmak
busı: bkŋz; buşı
kırırkus: kişi adı
Kusık: kişi adı
Uşıkı: kişi adı
uşan-: inanmak, güvenmek, itimad etmek, bkŋz; usanmak
ut-: utmak, yenmek, kazanmak, galebe çalmak, takip etmek, ardını bırakmamak, birisinin arkasına gitmek
utra: orta
utru: karşı, mukabil, dolayısıyla, doğru
utrun-: karşı gelmek, dayanmak, karşı koymak, mukavemet etmek, muhalefet etmek
utrunuk: karşıkarşıya
utun: küstah, utanmaz
utuz-: yuduzmak, yenilmek, kaybetmek
batut: gizli, saklı
bayakut: bkŋz; bayağut
buu: bkŋz; bu
kuun: harem dairesi
tuuş: bkŋz; tuş
vukuu: bir yıldız adı
yuul: dere, çay, küçük nehir, ırmak, bkŋz; yul
kutur-: delirmek, kudurmak, şuurunu kaybetmek
totı: bkŋz; tuurı
yul: bkŋz; yuul, çay, küçük nehir, dere, ırmak
uv: uyku
uvusuz: bkŋz; uvutsuz
uvut: edep yeri, utanma
uvutlu: edepli, terbiyeli
kuvra-: toplamak
kuvrat-: toplatmak
suvçı: kılavuz
suvluğ: sulu
suvluk: su kabı
suvsalık: susama, içki düşkünü, ayyaş
suvsa-: susuzlamak, susamak
suvsuş-: susamak
Yirsuv: tanrı
yuv-: aldatmak, kandırmak
suvunluk: parlaklık
uy: çukur
uya: yuva, çukur, mağara
uyak-: yıldızların sönmesi, batması, utanmak
uyat: haya, edep yeri
uyatlığ: edepli, hayalı, terbiyeli
uyul-: uyuşmak, kesilmek
uyur: adil, dürüst, amir
Buyançuk: kişi adı
Buyan kar: erkek adı
Buyan kara: kişi adı
Buyat: kişi adı
kunçuyluğ: kraliçeye, prensese özgü
kuyaş: güneş
kuyka: deri
suy: suç
Suyaklığ: yer adı
suyluğ: suçlu, kabahatlı
uz: usta, mahir, iyi, sanatkar, yol, geçit, dar boğaz
Uza: yer adı
uzağut: Madrabaz, mahir, eli çabuk
uza-: uzamak
uzakı: sürekli, devamlı, uzun süren
uzatı: daima, sürekli, uzun, devamlı
uzat-: refakat etmek, eşlik etmek, götürmek, uzatmak
uzıtı: bkŋz; uzakı
uziş: sanat
uzik bitig: mukaddes yazı
uzun: uzun, daimi, bkŋz; usun
uzun tonluğ: kadın
buzad: bkŋz; busat
Buzağu: erkek adı
buzağu: buzağu
buzluk: buzluk
tüp: dip, esas, temel, kök, son, zemin, bkŋz; tüb
yüp: bübütün, tamamıyla, olduğu gibi, kamilen
küniçi: hasut, kıskanç, günüci
san: san, sayı, hesap, vücut, kaba, baldır
sın: mezar, vücut, uzuv
yüd-: yüklemek, bkŋz; yütmek
tuş: eş, arkadaş, tesadüf, zaman, keyfiyet
yügürük: çabuk, acele, yüğrük
saniçar: zühal yıldızı
küisen: bkŋz; küşan
titrüm: kesin, kat'i, bkŋz; tütrüm
türtüm: zeki, kabiliyetli
tütrüm: derin, kat'i, kesin
üsüm: üzüm, bkŋz; üzüm
üzüm: üzüm, bkŋz; üsüm
ün: ses, seda, ün
ünçü: inci
ündür-: çıkarmak
üŋür: mağara, bkŋz; ünkür
ün-: dışarı çıkmak, çıkmak, yükselmek
ünte-: seslenmek, çağırmak, ünlemek
kentün: kendi kendine
küp: küp, kap
sakın-: düşünmek, düşünüp taşınmak, plan kurmak, endişelenmek
ür: uzun zaman, müddet, süre, tezgeç, ekin
ürgi: bkŋz; örgi, yüksek
ürke: eskiden, vaktiyle, zaman, müddet, süre
ürkit-: ürkütmek, korkutmak
ürk-: ürkmek, korkmak
ürkür-: ürkütmek, korkutmak
ürlük: sabit, değişmez, daimi
ürlüklüg: sabit, ebedi, ölümsüz, daimi
ürmen: bkŋz; örmen, bir çeşit hastalık
ürt-: örtmek
ürtül-: örtülmek
ürük: devamlı, sürekli, uzun vadeli, daimi
birtür-: verdirmek
üsüksüz: bkŋz; üzüksüz
üsül-: bkŋz; üzülmek
üsüt: bkŋz; üzüt
küs: bkŋz; küz
küsed-: bkŋz; küzetmek
küsin: bkŋz; küsün
küsün: güç, kuvvetli
külüş-: gülüşmek, gülüşme
küşalun: (Sanskritçe kusāvāti)
ütle-: tedris etmek, öğretmek, ders vermek
ütüg: ütü
ütüle-: ütülemek
beküt-: berkitmek, sağlamlaştırmak
Küten: kişi adı
küte tur-: beklemek
ögüt: ögüt, nasihat
küü: bkŋz; kü
tüü: bkŋz; tü, saç
yüü: özsu, öz, üsare, su
yüüz: bkŋz; yüz, çehre, yüz, sima
üveteçi: şişiren, tahris eden
üvet-: şişirmek, tahris etmek
küvre: çürümüş ceset, leş
üyür: lapa, bulgur
küyür-: yakmak
üz buz: yıkılma, çökme
üze: üstte, yukarda, üstünde, bkŋz; öze, ile
üzeki: üstteki, yukarıdaki
üzeŋü: üzeŋi
üzesinde: katında, önünde, huzurunda
üzkünde: bkŋz; üskünde
üzle-: kalkınmak, kalkmak
üzlünçü: nihayet, sonunda, en sonda
üzlünçülüg: sona ermiş
üzlün-: sona ermek, bitmek, tükenmek
üz-: kırmak, koparmak, yoketmek, delmek, parçalamak, bozmak, uzaklaştırmak
üzmele-: kökünden çıkarmak
üztün: bkŋz; üstün
üzüt: ruh, can
üzük: kalem
yaşağu: hayat, kainat, varlık, mevcudiyet
yutuz: zevce, refika, eş
vzir: bkŋz; vçir
yevek: bkŋz; yivek
kalan: vergi çeşidi, arazi vergisiz
salığ: vergi nevi, kaba, pis, salak
Tarkan: vekil, nezir, nazir, kişi adı
keriş: çekişme, kavga, niza
talaş-: bkŋz; dalaşmak, vuruşmak, kavga etmek, itiraz etmek
terkiş: kavga
toruş: kavga, niza
yöntüş-: mücadele, kavga etmek
Tavğaç: Çinli, Çin
yavğan: yavan
tavkaç: bkŋz; tavğaç
yinçü: inci, mücevherat
kavıra: kısaca, özet olarak
kavış-: kavışmak, kavuşmak, buluşmak, birleşmek
tavış: gürültü, şamata
yavış-: yaklaşmak
toŋa: yigit, kahraman, kuvvetli, şevketli
savlaş-: sözleşmek, haberleşmek
yvlak: bkŋz; yavlak
kız-kız: genç hanım, kız evlat
vruni: (Sanskritçe varuna), ilah adı
kavrıl-: kavrulmak
tavrak: çabuk, acele, süratle
tavran-: davranmak, acele etmek
tavrıl-: bkŋz; tevrilmek
tavsaŋ: ilahi ve mukaddes yer
tüz-: dizmek, düzeltmek, tavsiye etmek
kavşadıl-: birleşmiş, kavuşturulmuş olmak
kavşa-: kaynaşmak
kavşatıl-: karışmak, sarsıtılmak, heyecanlanmak
kavşat-: çevirmek, sıkışmak
savşiŋ: özel ad, küçük taşıt aracı, taşıt (?)
vuçuŋ: bkŋz; bitig, kaybolan belge yerine yeniden verilen alındı, senet
vuşanti: tanrı adı
kavur-: bkŋz; kavırmak
sançıl-: vurulmak
sançış-: vuruşmak
tokıt-: vurdurmak, tokutmak, kurdurmak
toŋla-: vurmak
toŋluğ: vurulmuş olan
yançış-: vuruşmak, sançışmak
karaklık: güç, kuvvet, iktidar
toŋalığ: güçlü, kuvvetli
türk: güç, kuvvet
türklüg: Güçlü, kuvvetli
kavzadıl-: çevrilmiş olmak
kavza-: dayatmak, sıkıştırmak, sıklaştırmak
tarık-: kaybolmak, uzaklaşmak, sıkılmak, kederlenmek, kaygulanmak
yıtlın-: erişmek, gitmek, gözden kaybolmak
yitil-: kaybolmak
yit-: yetişmek, erişmek, yükselmek, yitmek, kaybolmak
yitür-: kaybetmek, elden çıkarmak, artırmak, yidirmek
yokad-: yok etmek, ölmek, kaybolmak
saltur-: saldırmak, koydurmak
turuk: ışık, aydınlık, bkŋz; toruk
yaltrır-: aydınlatmak
yaruk: ışık, aydınlık
yaru-: parlamak, ışıklanmak, aydınlanmak
yarut-: parlatmak, aydınlatmak, görünmek
yaşut-: aydınlatmak, ışıklandırmak
yeg: yeg, iyi, pek iyi, bkŋz; yig
Yegen: kişi adı
yegirmi: bkŋz; yigirmi
yegirminç: yirminci
yegü: tıraş bıçağı (?)
yek: şeytan, peri, yek sağınçı 'şeytani fikir'
Yeke: kişi adı
Yeken: kişi adı
yem: bkŋz; em, ilaç
yeme: bkŋz; yime
ye-: bkŋz; yimek
yene: yine, tekrar, bkŋz; yine ~ yana
yeŋe: yenge, bkŋz; yeŋge
Yer: bkŋz; Yar
yetiş: başarı
yetiş-: başarmak
yėg: daha
kayet: son derece, gayet
yıdı-: kokmak
Yığaç: müşteri yıldızı
yığıl-: toplanmak, yığılmak
yığın-: toplamak
yığıt: ağlama, bkŋz; yığıt sığıt
yığ-: yığmak, toplamak, kazanmak
yığlaş-: ağlaşmak
yık-: bkŋz; yığmak, yıkmak, atmak
yıl: yıl, sene
yılıd-: ılıtmak, ısıtmak
yılkı: hayvan sürüsü (at), davar
yıltıra-: parlamak
yıltız: esas, kök, temel
Yımış: kişi adı
yın: bkŋz; yin
yır: şarkı, türkü
yırak: ırak, uzak, bkŋz; ırak
Yırım: kişi adı
yırtıl-: yırtılmak, yarılmak
yırt-: yırtmak, parçalamak
yıt: bkŋz; yıd
yıtık: kokmuş, çürük, pis kokulu, bkŋz; yıdığ
yid: bkŋz; yıd
yid-: bkŋz; yitmek
yiçe: daha, bir daha, tekrar
yiged-: yükseltmek, yüceltmek, galebe çalmak, üstün gelmek
Yigen: kişi adı
yigen: yiğen
yigi: sık, sıkı
yigid-: artırmak
yigirmi: yirmi
yigit: delikanlı, yiğit, genç
yigit-: hayatını kazanmak
yigü: yemek, yenilecek herşey
Yiken: stupa
yil: yel, rüzgar
yilik: ilik (kemik), bir memuriyet adı
yilim: tutkal, çiriş
yilin-: yapışmak
yil-: asmak
yiltir-: estirmek, esmek
yiltiz: bkŋz; yıltız, kök, temel, esas
yim: yem, yemek
yime: yine tekrar, yeniden, bkŋz; yeme
yimiş: yemiş, meyve
yin: deri, cilt
yken: yiğen
sayka-: içki koymak
bayka-: dikkat et-
yoğur-: yoğurmak, yumuşatmak, yatıştırmak, teskin etmek, aykırı gitmek
ylan: bkŋz; yılan
yltruk: süs, el süsü
yayla-: bkŋz; yailamak
yaylık: bkŋz; yailık
yme: bkŋz; yime
Tuynak: kişi adı
küntekü: gerdanlık, boynuna takılan süs
kayına-: kaynamak
kayıntur-: kaynatmak
turalığ: hareketli, canlı, oynak
yoda: bkŋz; yota
yod-: sonuçlanmak, sona erişmek
yoğ: yok, yuğ, ölü yemeği, matem, yas
yoğurt: bkŋz; yorğurd
yoğun: kalın, yoğun, kaba
yoğunat-: kalınlaştırmak, yoğunlatmak
yok: yok, kötü, fena, bkŋz; çığay, yoksul, fakir, sefil
yoka kadız: tarçın
yokaru: yukarı
yokla-: yükselmek, çıkmak, aramak, taramak
yoksuz: lüzumsuz, boşuna, yoksul
yolun-: yolda olmak, yola çıkmak
yoŋla-: istifade etmek, yararlanmak, işletmek
yoŋlağılığ: bkŋz; yuŋlaklığ
yon-: yonmak, yaralamak, ziyana sokmak
yögerü: bkŋz; yügerü
yökerü: yukarı (?), bkŋz; yügerü
Yökesiri: kişi adı
yök-: heyecanlanmak, duygulanmak, hislenmek, dalmak
yörgel-: sarılmak
yörge-: sarmak, örmek, çevrelemek, bağlamak
yörgen-: sarılmış olmak
yör-: açıklamak, izah etmek, aydınlatmak
yörüg: izah, açıklama, şerh
yörüŋ: açık, beyaz
yötül: öktürme, öksürük
kay-: kaymak, meyletmek, yönelmek
sarı: taraf, yön, cihet
bodun: devletin yönettiği topraklardaki halk
yraşı: bkŋz; yaraşı
yratın-: bkŋz; yaratınmak
yrlığ: bkŋz; yarlığ
yrlıka-: bkŋz; yarlıklamak
yrlıkançsız: bkŋz; yarlıkançsız
yrlıkançuçı: bkŋz; yarlıkançuçı
yru-: bkŋz; yarumak
yruk: bkŋz; yaruk
kayra: inayet, nasip
kayrala-: inayet etmek, nasip etmek
ayran: kımız
Kaysadu: kişi adı
taysu: (Çince) Prens
yarası: itaatli kimse, uysal
çaytı: manastır
Kaytasu: kişi adı
kalaşatari: bir şeytanın adıdır
yud-: bkŋz; yıkmak, tahribetmek, silmek
yudul-: bağlanmak, takılmak
yudun-: bitirilmek, silinmek, son vermek
yuk-: yapışmak
yulağ: bkŋz; yulak, ışık
yulak: bkŋz; yulağ
yula-: almak, koparmak, zorla elde etmek
yulat: oluk, ırmak yatağı, su arkı
yul-: yolmak, almak, pazarlıkla alış veriş etmek
yulka: meşale
yultuz: yıldız, burç, planet, gezegen
yuluğ: satın almak, bkŋz; birim, bir vergi türü
yu-: yıkamak, temizlemek, kaldırmak
yumurka: yumurta
yuŋuk: hamam
yuŋuluğ: yıkanma
yun-: yıkanmak
yunt: bkŋz; yont, at
yurt: yurt
yurun: paçavra
yutun: bkŋz; yudun
yügür-: koşmak, yügürmek, yürümek
yük: yük
yükle-: yüklemek
yüksek: yüksek
yükün: dizgin, hat
yülegü: ustura, bıçkı, bkŋz; yüligü
yüligü: ustura, bkŋz; yülegü ~ yülügü
yüleşi: benzer, müşabih
yüleş-: benzemek
yülügü: ustura, bkŋz; yülegü ~ yüligü
yülüş-: bkŋz; yüleşmek
yüŋ: pamuk, yün
yürek: yürek
yür-: yürümek, koymak, sokmak
yürül-: gerilemek, şişmek
yürü-: yürümek
yürünteg: ilaç
yütür-: yüklemek
yüz: bir kulak hastalığı, yüz, yüz, çehre, sima
yüzintegi: yüzündeki, simasındaki
yüzken: durmadan, mütemadiyen, aralıksız
yüzlen-: yüz çevirmek
tüş: mükafat, semere, netice, sonuç, ürün, yemiş, meyva
kızamuk: kızamuk
kızart-: kızartmak, kor haline getirmek, kırmızılaştırmak
suzak: köy, bkŋz; sazak
tuzçı: tuz satan
küzet: karakol
kuzğun: kuzgun, karga
yantur-: çevirmek, geri döndürmek, çıkmak (rüzgar)
kazğuk: kazık
kuzğut-: yakmak
sızğur-: erimek
kazkuk: bkŋz; kazğuk, kazık
kızkut: bkŋz; kızğut
kızığ: bkŋz; kısığ
kızıl: kızıl, kırmızı
sızıl-: erimek
yazınç: yazuk, günah
yazın-: günah işlemek, karşı gelmek, istaatsızlık etmek, yanılmak
yarık: zırh, kıyı, kenar
kizik: gezi, seyahat
siziŋ: sizin
siziŋe: size
tizik: seyahat, gezi, bkŋz; tisik
tizit: bkŋz; tizit
kızkıl: kırmızı
kizle-: gizlemek, saklamak
Kazluk: göl adıdır
sızlağ: bkŋz; sıslağ
sızla-: sızlamak
sızlat-: sızlatmak
tözlüg: temelli, köklü, asaletli, asli olan
Tüzlüg: kişi adı
Tüzmiş: kadın adı
küznek: gölge
kıznak: hazine
sizni: sizi
tarazuk: terazi, bkŋz; tiraznk
taŋağ: korku, sıkıntı, endişe, zor
taŋış: korku, ıztırap, sıkınıtı, cebir, zor
Yişu: hazreti İsa
kızsız: tokluk, gözü tok
āzu: bkŋz; azu
kazuk: kazık
tuzu: bkŋz; tusu
yazuğ: bkŋz; yazuk
yazuk: günah, suç, hata, kusur
tüzü: bkŋz; tözü, kusursuz, tamamı, bütünü, hakikatli
tüzük-: müsavi kılmak, eşit kılmak
tüzül-: dizilmek, sırada olmak
tüzün: asil, necip, soylu, tekmil, kamilen, hakiki, bkŋz; tözün
basınç: basınç, tazyik, baskı
taŋıl-: sıkıştırılmak, tazyik edilmek
tatağlağ: tatlı, lezzetli
satabiş: bir yıldız adı
sanlığ: sanlı, hürmetli, ait olmak, başkasına tabi
teŋ: denk, her çeşit, her nevi, benzer, müşabih, terazi, siklet, ağırlık, kadar, ölçü
kas: bkŋz; kaş, kabuk
kasık: kabuk
taŋlançığ: hayrete şeyan, acayip, harika
yota: bacağın üst kısmı
Keri Açarı: kişi adı
Sançanaçavi: erkek adı
taş-: kaçmak, taşmak, çıkmak
yaltır-: parlamak, ışık saçmak
Kutaçun: kişi adı
sakış: düşünce, endişe, madde, kaygu, hesap
salt: aded, tane
Yasadu: kişi adı
yarun: şafak, gün ağarması, tan atması
yinik: hafif, kolay, değersiz
yiterü: yetecek kadar, kafi miktarda
kağan: hakan, kağan
kağatır: katır
kağın-: bkŋz; kakınmak
tarağlağ: bkŋz; tarığlağ
tatağlan-: tatlılanmak
tayağlığ: destek
yaratağlağ: bkŋz; yaratığlığ
sınıla-: ağlamak
kağuk: mesane
kağun: kavun
kağur-: kavurmak
kağuş-: kavuşmak
karağu: siyah, kara
kıtığ: kıyı, kenar, sahil, sınır
takı: dahi, ve, kaldı ki, nihayet, bundan başka
tanuk: tanık, şahit
kirit: anahtar
yortu: tahta
yaikan-: dalgalanmak, sallanmak, çalkalanmak, sarsılmak
yaila-: yazı geçirmek, yaylamak, bkŋz; yaylamak
yailık: yazlık (ev)
kit-: gitmek, zail olmak
sudar: kutsal kitap (sutra), soy kaydı, aile ağacı
yay-: yaymak, bkŋz; yaimak
Sav: kainatın adı
künteki: harem dairesindeki
kanlık: han'lara ait bir vergi
karınlığ: karınlı, karına ait
kakalan: bir vergi adı
sakan-: bkŋz; sakınmak
yakala-: tanzim etmek, düzenlemek, düzene koymak
Yakan: kişi adı
bayakı: yukarıda geçen, deminki
kakın-: nedamet etmek, pişman olmak
Kay Sakık: kişi adı
sakız: sakız
Takıçuk: kişi adı
Tayakı: yer adı
Sartavaki: özel ad
sakla-: saklamak
saklan-: sakınmak, saklanmak, çekingen olmak
tayaklığ: dayanılan, istinad edilen
yaraklığ: bkŋz; yarağlığ
batur-: gizlemek, saklamak
kara-: bakmak
tak-: takmak, bağlamak
tamıt-: yakmak, parlatmak
titir-: sert ve dik dik bakmak, keskin bakışla bakmak
kataş: akrep
taksız: dertsiz, gamsız
yaksa: bkŋz; yaksa
tetrü: aksine, tersine
tur-: ayakta durmak, kalkmak, durmak
takunla-: bkŋz; tağunlamak
yakuru: bkŋz; yağuru, yakın (yer ve zaman için)
yakud: yakut
Alaş: Amin
Alaz: Amin
kala: kale, şehir
kalak: kale, gök
Talas: yer adı
titig: balçak, çamur
yan: taraf, kalça, yan
küret-: aldatmak, aldanmak
yalkan-: aldanmak
yalan: alev, bkŋz; yalın
yalın: alev, parıltı
yalınla-: alevlenmek
yalınlığ: alevli, parlak
yala-: yalamak, bkŋz; yalğamak
yalka-: bkŋz; yalğamak
kalı: artık, arta kalan
kalığ: kalık
kalık: gök, yukarı kat, tavan arası
kalın: çok, sayısız, sık, pek, kalabalık, koyu
kalınçu: yığın, kalabalık, bırakılmış, arta kalan, arta kalan, çamur, artık
Kalıŋ Kara: kişi adı
Sali: kişi adı
katun: hatun, kadın, kraliçe
yalkat-: bağlamak, eklemek
yalk-: bir şeyin gerçekleşmesine engel olmak, engellemek
salın-: sallanmak, dikmek
salıntur-: sallandırmak, sallatmak
tarmukluğ: kanallar gibi, dereye benzer
kal-: kalmak
yaltrak: ışık, parıltı, bkŋz; yaltrık
yaltıra-: parlamak
yaltrık: parlaklılık, ziya, ışık
yaltrıklığ: parlak, ışıklı
yaltruk: bkŋz; yaltrık
Salu: erkek adı
talula-: seçmek, intihap etmek
taluk: tedavide kullanılan bir bitki türü
toluy: deniz, bkŋz; taluy
İt Saman: kişi adı
kamak: bkŋz; kamağ
saman: saman
suyurkamak: bkŋz; tsuyurkamak
Tamağ: yer adı
tamak: damak, gırtlak, boğaz
tamar: damar
Tamasavan: bir manastırın adı
yaman: kötü, fena, korkunç
kamış: saz, kamış
tamır: bkŋz; tımır, damar
tamış-: damlatmak
tamız-: damlatmak
yamız: kasık, bkŋz; yomuz
saŋa: sana (zamir)
siz: siz (zamir)
katın-: sağlamlaşmak, sertleşmek, katılaşmak
kamuş: bkŋz; kamış
batatu: pamuk
kıtık: pamuk
kıtıklığ: pamuklu
kanağ: kan alma
kana-: kan almak
sançığ: kanca, sancı
tertü: yalancı, hileli
yat: yad, yabancı, bkŋz; yad
yatla-: düşmanca hareket etmek, yabancı saymak, kaçınmak, uzaklaşmak
buranç: havasızlık, sıkıntılı
yandur-: çevirmek, döndürmek, bkŋz; yanturmak
kal: kaçık, deli, delilik, kudurmuş, divane
yarma: tane, yarma
yava: (Sanskritçe), tane, ekin
kayu: hangi, hangisi, kim
taŋığ: bkŋz; taŋağ, korku, sıkıntı
taŋız-: şişmek
yaŋı: yeni, taze, gün
Yaŋıçun: kişi adı
yaŋıl-: yanılmak
yaŋıluk: bkŋz; yaŋluk
yaŋırtı: yeniden, tazeden, baştan
taniş: bkŋz; daniş
kanlığ: kanlı
sanlağ: sayın, sanlı, hürmetli
taŋlançık: bkŋz; taŋlançığ
yaŋluk: hata, yanlış, bkŋz; yaŋıluk
yaŋlık: yanlış, hata, bkŋz; yaŋluk
tuyuz-: anlatmak, duyurmak
kün ay: tanrı adıdır
yalaŋus: bkŋz; yalaŋuz
yanut: karşılık, bedel, cevap
saŋun: general
yaratın-: tanzim ve tertip etmek, düzenlemek, süslenmek
teŋle-: ölçmek, hesaplamak
tuŋa: kaplan
Ket Kara: kişi adı
kadız: tarçin
sın-: kırılmak, parçalanmak, sınmak
tançu: dilim dilim, parça parça
tançula-: dilimlemek, parçalamak
i-: arkasınca gitmek, ardına düşmek
kisari: (Sanskritçe kesarin), arslan
tark: dert
tarkan-: sıkışmak, sıkılmak
Yarkaya: kişi adı
yarlık: bkŋz; yarlığ
yarmak: sikke, para, kırmak, yarmak, parçalamak, ayırmak, sabit, kımıldamayan
yarman-: tırmanmak, çıkmak
tartığ: armağan, hediye
bar (a) m: bkŋz; barm
bulula-: karışmak, karmakarışık olmak
tuşuş-: karşılaşmak, rastkaşmak
yantut: karşılık, ivaz, bedel
yaz-: hata etmek, günah işlemek, yanılmak, karşı gelmek, yazmak
tartıl-: dışarı çıkarılmak
tartış: kadın adı, armağan
tart-: tartmak, çekmek, almak
yartan: bölük, yarım, parça, kısım
yartım: parça, kısım, bölük
yart-: bkŋz; yarmak, sikke, para
taruka: bkŋz; daruğa
taru-: daralmak
Yaruk: kişi adı
yaruksuz: ışıksızlık, karanlık
yorığ: gidiş, yürüyüş, yol, usul, tarz
Basan: kişi adı
Kançanasarı: bir kral adıdır
yasa: yasa, kanun
yasak: bir çeşit vergi, kanun, yasa
küni: kıskançlık, haset günü
kasığ: kasık
kasınçığ: korkulu, korkunç
sasığ: çürük, kokmuş, fena
sası-: kokmak, çürümek, fenalaşmak
sasıt-: kokutmak
tasıl-: bkŋz; taşılmak
tasık-: bkŋz; taşıkmak
yasıç: ok
yasımuk: darı
yaşuksuz: ışıksız, ziyasiz
kumaru bitig: vasiyet
tutuk: askeri vali, (Çince tu-tu)
kasuk: çivi
yasul: yokuşlu, eğri
yasu-: bkŋz; yaşumak
yasuk: bkŋz; yaşuk, bkŋz; yazuk
başa-: yenmek, üstün gelmek
kaşak: kamış, saz
kaşan-: işemek
yaşa-: yaşamak, ....yaşında olmak
yaşar-: yeşillenmek
kutıkı: aşağı, baya
yaşığ: yaşayış
yaşıl: yeşil
yaşı-: saklanmak, gizlenmek
yaşırlığ: saklı, gizli
yaşıt-: saklamak, gizlemek
Kaşi: kişi adı
kat-: katmak, eklemek, sertleşmek, katılaşmak, karıştırmak, takatsızlaştırmak
katun-: sertleşmek, katılaşmak
sınaş-: sınaşmak, birbirini sınamak, boy ölçüşmek
yaraşur-: yakıştırmak, bkŋz; yaraşurın
yaşuk: ışık, ziya, parıltı
yaşu-: parlamak, ışımak
yaşur-: saklamak, gizlemek
yaşurukı: gizli, saklı olan
yaşut: gizli
katak: bkŋz; kadağ, bkŋz; kadak
kata-: bkŋz; katmak
katar-: çevirmek (?)
katas: bkŋz; kadaş
satağ: bkŋz; satığ
katıl-: katılmak, karışmak
katın: bkŋz; katun
katır: sağlam, pek
Satı: özel ad
kuşavati: (Sanskritçe kusavati)
bat-: batmak
Batuk: kişi adı
Batur: kişi adı
Katuk: kişi adı
satun: sarımsak
yatur-: yatırmak
kavalığ: ekin adı
yaval-: güçlenmek, kuvvetlenmek
yavaltur-: yumuşatmak, teskin etmek
yavaz: bkŋz; yavız ~ yabız, kötü, fena
keŋiş: danışık, müşavere
Tatar: kavim adı, lakap
tayançı: müşavir, sırdaş
teŋlig: ölçülü, müsavi, denk
İl Kaya: kişi adı
Mayak: özel ad
kaya: geri, kaya
Kaya: kişi adı
Kayak: kişi adı
tayak: dayak, destek
kit: son, nihayet
ėrgü: amaç, gaye
Tayınçak: kişi adı
yayıl-: yayılmak, dökülmek, taşmak, dağılmak
yayıt-: sarsmak, titretmek
