abınçu: cariye
korag: cenaze töreni
küŋlüg: cariyesi olan, cariyeli, cariye sahibi
küreg: casus
yegir: ceylan
yog: cenaze töreni, defin töreni
yoglat-: cenaze töreni yaptırmak
çabış: başkumandan
çak: tam, tamı tamına, çağ, dönem
çekik: tarla kuşu
çıntan: sandal ağacı
çıŋız: güçlü
çub: bölge, mıntıka
tuso: fayda, yarar
buğu: erkek geyik
ılag: otlak
ılga: vadi, ırmak kıyısı
ınal: sadık
ınçıp: böylece
ıngaru: sonra, ondan sonra
ır: şarkı
ıt-: yollamak, göndermek
ıy-: basmak, egemenliği altına almak
teŋriken: efendi, majeste
ulu: ejderha (yıl adında)
laçın: şahin
manıstan: manastır
meŋile-: sevinmek, mutlu olmak
meŋin: benim
meŋle-: (vahşi hayvan) avlanmaya çıkmak, yiyecek aramak
munda: burada (n)
negü: nere
nugoşak: dinleyen, dinleyici
oçuk: ocak
ogad-: elde etmek, imkân bulmak
ogadma-: elde edememek, imkân bulamamak
ogıl: çocuk, oğul, evlat
alpagut: kahraman
kap: kapmak
kapıg: kapı
kapırçak: tabut
kopın: hepsi, hep birlikte, bütünüyle
opa: ova, düzlük, taş yığını
sap-: eklemek, bağlamak
sıpa: bir yaşındaki eşek yavrusu
şarga: arslan
üçegün: üçü, üçü birlikte
üç elig: kırk üç, 43
üç yėgirmi: on üç, 13
üç yėtmiş: altmış üç, 63
üç yüz: üç yüz
üdsig: yaşlı
ügür: sürü
ügüş-: aşınmak, ufalanmak
üküş: çok, çoğunluk
ülgen: ulu, yüce, büyük
ülke: yurt
ümele-: misafir olmak, misafirliğe gitmek
ün-: çıkmak, yükselmek, kalkmak
üntür-: tan atmak (harfiyen; yükseltmek, çıkartmak)
üŋüş-: parçalanmak, yırtılmak
ürüŋ: beyaz, ak, parlak
üt: öğüt, nasihat
ütle-: öğütlemek, nasihat etmek
üz: aksi, inatçı
artukı: ve, ayrıca
ir-: varmak, ulaşmak
udu: ve, sonra
tegim: saldırı, taarruz
aba: yaş olarak büyük olan bir kimse, ced
abıçga: yaşlı, yaşlı kimse
ėb-: acele etmek
terkleyü: acele ile, hızlı hızlı
yėl-: acele etmek
alumçı: devlet alacaklarını tahsil etmekle görevli kimse
ataç: baba, babacık
butlug: bacaklı
emsi-: zehirlenmek, ağzı zehir gibi acılaşmak
ezençü: ızdırap, acı
kaŋıç: babacık
kuz: kuzey, dağın kuzey yamacı
tutsık: (ülke) kurulacak (yer)
açış-: birlikte açmak
açsık: aç, tok değil
kaç: kaç
kaçan: her, her ne olursa, her zaman
yaratıg: açma, meydana getirme
kigür-: sokmak, girdirmek, girmesine yol açmak
yılıg: yumuşak mizaçlı
adın: başka
adınç: seçkin, mümtaz
ulgadtur-: büyütmek, yetiştirmek
berüki: berideki, bu taraftaki
keçe: geçe, öte, ötesinde, öte taraf
korıgu: muhafız
öŋre: ön tarafta, önce, doğuda, ileride
taŋlar-: tan atmak, şafak sökmek
tonlug: giyimli, kıyafetli
tupul-: delinmek, (savaşta) safları yararak düşman güçlerinin arasına atılmak
yakılıg: taraflı
agın: dilsiz
agıntır-: (göğe) yükseltmek
ėçiç: ağabeycik
özlik: has, saraya mahsus, hakanlığa ait
akça: akçe, para
akınçu: akıncı, baskıncı
akıt-: akın etmek, akın ettirmek
akız-: akın etmek, akın ettirmek
ançak: henüz, sadece
armak: aldatmak, kandırmak
armakçı: sahtekar, hilekâr
bodrak: kahverengi
alın-: alınmak
alıt-: yakalatmak
alk-: yok etmek
altız-: aldırmak, yakalatmak
kamagı: hepsi
kamşag: sarsıntı, sarsılma
kamşat-: sarsılmak
yamaş-: katılmak
ançıg: öyle, öylece
anın: üzerinden, oradan, böylelikle, bu şekilde
anıŋ: onun
anta: ondan, orada, o zaman
antag: öyle, o kadar, şöyle
antık-: yemin etmek
antlıg: antlı, andı olan
antsız: antsız, andı olmayan
anyıt-: korkutmak
aŋa: ona
aŋar: buna, ona, onlara, onun
aŋaru: ona doğru
ar: at
arguy: siper
arı-: arınmak, temizlenmek
arıg: iyi, temiz
arkkış: övgü
arkuk: aksi
art-: artmak, çoğalmak
basa: sonra
basık-: gömülmek
yas: yas, matem
küregü: asi yaradılışlı
totok: askeri vali
tutuk: askeri vali, bölge yöneticisi
aşan-: yemek yemek
aşnu: önce, eski
başgıl: alnı akıtmalı at
başlayu: önce
kaşga: alnı akıtmalı (at)
saş-: şaşırmak, yanılmak
taş-: artmak, çoğalmak
taşdın: siyasal merkezin dışı
taşgar-: çıkarmak, dışarı çıkartmak
taşra: dışarı, dışta, dıştan
umugdaş: kutlu
yaşça: (yaşı) olgunlaşmış
yoŋaşur-: (birbirine karşı) kışkırtmak, birbirine düşürmek
at-: atmak
ata-: atamak
ata: baba
atan-: atanmak, göreve getirilmek
atan: iğdiş edilmiş deve
atı: yeğen
atız: küçük alan, toprak
atlan-: ata binmek, atlanmak
atlat-: ata bindirmek
aya-: koruyan, sayan
aymag: oymak, aşiret
ayıgma: danışman, sözcü
ayok: hüküm, buyruk, emir
ayt-: buyurmak, emretmek, sormak
ayur: anlatıcı, râvi
kay-: geri dönmek
kotay: ipekli kumaş
say: çakıl taşı
tay: büyük, yüksek rütbeli
ulayu: özellikle, bunlara ilaveten, ve ayrıca
yaŋılayu: tekrar, yeniden
azça: az miktarda
azıglıg: yaban, yabanî
azış-: ayrılmak
azkınya: az, azıcık
azuksız: azıksız, yiyeceksiz
bazlan-: bağımlı olmak
yazın-: hata etmek, yanılmak
yazma-: inanmamak, kanmamak
bagla-: bağlamak, evlendirmek, başını bağlamak
baglıg: bağlı, birleşik
baŋaru: bana doğru
barı: hepsi
barmış: zengin, müreffeh
ebçi: eş, zevce
bedizlig: resimli, yazılı
begiç: beycik
begrek: soylu bey
beŋi: mutlu
beŋlig: benekli
beŋülük: bengü, ebedî
berk: sağlam, dayanıklı
bert: hediye
berü: beri, geri
bė: kısrak
bėl: bel, sırt
ėki bıŋ: iki bin, 2000
kalıt-: yolu bırakmak, gidilen istikameti değiştirmek
bidgüçi: yazıcı
bilme-: bilmemek
bini: beni
bintegi: benim gibi, bana benzer
biri: güney
biriki: birleşik, müttehit
bişük: akraba
bitigçi: yazıcı, taş ustası
bo: bu
boçegü: bu üçü birlikte
bodun: boy, boylar, halk
bokun: halk, topluluk
bokursı: saban
bonça: bunca
bonta: burada
boşgur-: eğitmek, öğretmek, akıl vermek
boşun-: kurtulmak
boşunul-: serbest kalmak
boto: deve yavrusu
botola-: (deve) doğurmak
boymul: (beyaz) boyunlu
buz-: bozguna uğratmak, yenmek
buzkun: bozgun
kezü: boyunca
bök-: doymak, hasret gidermek
böke: güçlü
bökme-: doymamak
böşük: akraba
ikegü: iki, iki parça, iki bölüg
kubra-: toplanmak, bir araya gelmek
kubrat-: derlemek
budla: deveye takılan burunsalık
bukursı: saban
bulganç: kargaşa, karışıklık, kargaşalık
bulgat-: karıştırmak, karışıklık çıkarmak
bulna-: tutsak almak, esir etmek
bulug: buluş, arayış
bulun: esir, tutsak
bunı: bunu
bunta: burada
busanç: keder, üzüntü
busuşlug: kederli
buzagu: buzağı
buzagula-: buzağılamak
büçegü: bu üçü birlikte
erle-: büyümek, yetişmek
tözü: bütün, hep
esre-: beslemek, büyütmek
et-: ses çıkarmak, gümbürdemek, ötmek
ödüş: gece boyunca, bütün gün
tolku: yekpare, tek parça, tamamıyla, bütün
tom: tamamen, büsbütün
isig: sıcak, aziz, sevgili
koduz: kadın, dul, kocasız kadın
kudı: aşağı, aşağısına doğru, akıntısı boyunca
kumursga: karınca
ötünç: rica
tirgür-: diriltmek, canlandırmak
yeme: dahi, hem de, ayrıca
eçü: ata, ecdat
kürlüg: hilekâr, aldatıcı
eligçe: elli civarında
ėkinti: ikinci, ikinci olarak
yinçü: inci
yüzçe: yüz civarında
küzençü: koruyucu
urugsuz: çocuksuz, soysuz, dölsüz
kölek: küçük göl, gölcük, bataklık
törtünç: dördüncü
yėlme: öncü, devriye, öncü birlik
yolagçı: öncü (birlik)
ukuşça: akla uygun, mantığa uygun
kerekülüg: çadırlı
tegiş: çarpışma
yiş: çayır, mera
ėkegü: iki parça
kėçe: akşam
yiçe: önceki gibi, tekrar, yeniden
ermeli: çevik at, hızlı at
içger-: bağımlı kılmak, bağlamak
içgerme-: tâbi kılmamak
içgin-: bağımlı olmak
yogçı: yasçı
içikme-: tâbi olmamak
keçig: geçit
öçi: ihtiyar kadın
ölmeçi: ölmeye yüz tutmuş
yitmeçi: yok olmaya yüz tutmuş
ogra-: hıçkırmak, hıçkırarak ağlamak
ökünçlüg: üzüntülü, kaygılı, pişman
seçlin-: seçilip ayrılmak
küni: hasetlik, kıskançlık
suk: kıskançlık
yemlig: güçlü, kuvvetli
ert-: geçmek, gitmek
ertin-: pişman olmak, vazgeçmek
köç-: göçmek, göç etmek
tog-: aşmak, geçmek
ertiŋü: pek, pek çok
kum: kum, çöl
içre: içeri, içeride, bağlı
tor-: güçsüz düşmek, ölecek gibi olmak
singil: küçük kız kardeş
ėyin: daha sonra
küdegü: güvey
esini: değerli, kıymetli
ille-: devlet haline getirmek, devlet kurmak
illig: devlet sahibi, devletli
tegmiş: değmiş, erişmiş, ulaşmış
temir: demir
topul-: delmek
tıdıgsız: engelsiz, maniasız
udıgma: uyuyan
yaraklıgdı: silahlı olarak
bėridin: güneyden
ėdi: tümüyle
kėdin: batı
kidin: batı
yegdi: daha iyi bir biçimde
yėgdi: en iyi şekilde, daha iyi bir şekilde
olgurt-: diktirmek, yaptırmak
tėmiş: diyen, söyleyen
ödkünç: sahte, taklit
yitiglig: yetkin, idmanlı
ordo: ordu, ordugâh, ordunun toplandığı yer, otağ
öŋreki: doğudaki, öndeki
öŋtün: doğu
to-: doymak
tokuz yüz: dokuz yüz
tugsık: doğu
toktar-: dövdürmek, vurmak, ezmek
uyur: kudret (li), güç (lü)
ödsig: yaşlı
udşur-: takip etmek
uduz-: göndermek, kumanda etmek
tul: dul
ögürdü: neşe, hayat kaynağı
ėtit-: düzenlemek, düzenletmek
tügünlüg: düğümlenmiş, düğümlü, kuyruğu düğümlü (at)
ėtin-: (kendini) düzenlemek, örgütlemek, elde etmek
ögtür-: yüceltmek, övdürmek
sökül-: halsiz düşmek, bitap düşmek
ebir-: evirmek, çevirmek
ugrıŋa: uğruna, sebebiyle
kısıl: geçit, dağ geçidi
yılla-: yılı geçirmek
yugur-: geçirtmek, aşırtmak
ėrmiş: zengin, müreffeh
eşilik: hanım olmaya layık, hanımefendilik
yolı: kez, kere, defa
ėgri: eğri, hörgüç
egsük: eksik, kusur
ėgil: halk, avam, sivil halk
yüküntür-: bağımlı kılmak, boyun eğdirmek
ėki: iki, ikisi, 2
ėkiz: ikiz
ėki otuz: yirmiiki, 22
ėki yėgirmi: oniki, 12
ėki yüz: iki yüz
ėrkek: erkek
otuz artukı ėki: otuziki, 32
sekiz otuz: yirmisekiz, 28
sekiz yėtmiş: altmış sekiz
tezek: tezek, kuş pisliği
ėli: ülke, devlet
ėlig: hükümdar
ėlt-: sürmek, alıp götürmek
yėmşak: yumuşak
enç: huzur, sakinlik
eŋ: en, ilk, av
ėn-: inmek
ėnç: huzur, sakinlik
töpö: tepe
töpü: en üst, tepe
tüketi: tamamı, hepsi
eren: erler, asker, askerler
erinç: şüphesiz
erkli: olan, iken
erse-: özlemek
ėr-: ulaşmak, yetişmek
ėrig: ulaşılabilir, yakın
ėrte: sonraki
esne-: esnemek
ėsirke-: esirgemek, korumak
kėsre: sonra, geride, batıda
eşgiti: ipekli kumaş
eşin-: (at) koşturmak
ėşgiti: ipekli kumaş
ėşilik: hanımlık, sultanlık
yutuz: eş, zevce, harem
ėtiz-: yaptırmak, ettirmek
sözlet-: söyletmek
tigret-: (atı) yellendirmek
yėtiglig: yedekte
yėti yėtmiş: altmış yedi
yüget-: övmek
kėyik: yaban hayvanı
tėyin: diye
tezig: hızlı koşan
sinleg: mezar, mezarlık
yagıla-: savaşmak
timag: saygı
tėgit: prensler
kırgaglıg: kenarlı
ukuglı: anlayan, anlayışlı
yogla-: yas tutmak
kanıg: sevgili, gözde
küd-: beklemek, gözlemek
ogura-: karşılaşmak, görüşmek
yıd-: haber göndermek
ögsüz: öksüz, annesiz (at adında)
kugu: kuğu
oguz: gelin
takıgu: tavuk (yıl adında)
tugur-: (güneş) doğmak
iniygün: erkek kardeşler
küsgü: sıçan
ögün-: sevinmek, mutlu olmak
ögüz: ırmak
kalış-: birlikte ayağa kalkmak, baş kaldırmak, isyan etmek
turut-: ayağa kaldırmak, diktirmek
korgan: korugan, sığınak, kale
yany: dağıtmak, bozguna uğratmak
kunla-: yağmalamak, talan etmek
kunuş-: (karşılıklı) çalmak, yağmalamak
tartış-: (karşılıklı) çalmak, çalıp çırpmak, yağmalamak
yulıma-: yağma etmemek
utuş: uğur, yol
kot-: hediye etmek
yüre: hızla, hızlı bir şekilde
körlüg: hilekâr
yarıklıg: silahlı
yollug: bahtlı, şanslı, talihli
sorug: şan, şöhret, ün
olor-: tahta oturmak, tahta çıkmak, hüküm sürmek, yaşamak
olort-: tahta oturtmak, tahta çıkartmak
kılınç: âdet, huy, yaratılış
tıd-: engel olmak, durdurmak
kėrü: batı, batıda
yalık-: yalnız kalmak, tek başına kalmak
yarık: zırh
kılma-: yapmamak, etmemek
kokılıg: tütsü
yaŋılma-: yanılmamak, aldanmamak
os: iç kısım
yüd-: yüklemek, taşımak
sür-: sürmek, önüne katıp kovalamak
kaŋsıra-: babasını kaybetmek
kırıg: kıyı, kenar
yır: kuzey
yıril-: ayrılmak
kalmış: kalan, geri kalan
