nence: bir şeye göre
pakcan: hoşlanarak bakma, seyretme
pcem: maymun
şalcı: alp şalcı, özel ad
ucusla-: aşığı görmek, ucuzlamak
dakşan: (Sanskritçe dakşinā), hayır dua
Danadati: (Sanskritçe Dhanadatti), bir şeytan kumandanının adı
daranı: (Sanskritçe dhārāni), dua
daranılıg: dualı
darmad (ı) vaç (ı) : (Sanskritçe dharmadhvaja), bir burkan adı
Darmadini: (Sanskritçe Dharmadinnā), özel ad
damgalal-: müğürlemek
damgalıg: damgalı
ferzind: oğul veya oğlu
firişti: peygamber, melek
fişay: (Sanskritçe vişaya), his ve düşünme organı
frişti: (Soğdça frişti), elçi, ferişte, melek
gelin al: evlenmek
ğandarvı: (Sanskritçe gandharva), gökteki mızrakçılar
ğantazi: (Sanskritçe gandhāra), gılan hükümdarı
ğaŋavaluk: (Sanskritçe gangāvālukā), ögüzdeki kum
ğarh: (Sanskritçe graha), seyyare
ğarudı: (Sanskritçe garuda), efsanevi bir kuş
ğıntsuŋ: (Çince gen-ts'ung), Hüantsang'ın tercümesini tefsir yazan kimse
ğirant: (Sanskritçe grantha), Nazım, şiir, mısra, fasıl
ğitso: (Çince gi-dzö), Altun Yaruk'u Sanskritçeden Çinceye çeviren kimse
ğopalı: (Sanskritçe gopāla), bir şeytan adı
ğrah: (Sanskritçe graha), seyyare
ğrdrakut: (Sanskritçe grdhrakūta), bir şehir adı
Ajokrakkişiti: (Sanskritçe Aşokaraksita), özel ad
altumji: kuyumcu
anjulayu: bunun gibi
arji: (Sanskritçe rsi)
eji: on iki kien-çü-man'lardan biri
ejim: (Çince jen), 10'kan'dan 9.su
emjü: doktor, tabip
erji: (Sanskritçe rsi), dünyaya terk etmiş, münzevi
irji: (Soğdça rizai), (Sanskritçe rsi), evliya, münzevi
ujiksiz: hecesiz
üjik: (Çince tzü), hece
lağız: domuz
lakışmantı: (Sanskritçe lakşmimati), bir tanrı kızı adı
lakşanlıg: belirtili, işaretli
lağan: (Çince lan-kan), çit
raçabadrı: (Sanskritçe rajabhadra), bir şeytan adı
raçabrahmı: (Sanskritçe rājabrahma), bir burkan adı
raçagarh: (Sanskritçe rājagrha), bir şehir adı
raçagri: (Toharca rajagri), (Sanskritçe rajagrha), yer adı
radnaakkari: (Sanskritçe Ratnakara), bir burkan adı
radnaprabi: (Sanskritçe ratnprabha), özel adı
Raimast: özel adı
Radnavaçır: özel adı
retni: (Sanskritçe ratna), cevher, mücevher
rıdı: (Sanskritçe Rddhi), mücize gösterme veya büyü gücü
riti: büyülü güç, sihir, gizemli güç
ulaar: onlar
abarh: (Sanskirtçe abrha), bkŋz; abark
abark: (Sanskritçe avrha, avrhâ), bir tanrılar diyarı adı
abasvar: (Toharca âbbâswar), (Sanskritçe âbhâsvara), bir tanrılar diyarı adı
abavapur: (Toharca, Sanskritçe abhāvāpura), yer adı
abıdarım: (Sanskritçe abhidharma), bkŋz; abidarim
abıdıyı: (Sanskritçe abhidheya)
abımukı: (Sanskritçe abhimukhī)
abıpşay: (Sanskritçe abhipaśya), bir yer adı
abıyas: (Sanskritçe abhyāsa)
abidarim: (Sanskritçe abhidarma), Vasubandhu'nun eserinin adı
abipiray: (Sanskritçe abhiprāya), mana, meal
abipiraylığ: (Sanskritçe abhiprāya+Tü+lığ), manalı
abiruş: ağaç
açala: (Sanskritçe acalā)
açataştru: (Sanskritçe ajataşatru)
Açita: (Sanskritçe Ajita), özel ad
açkaç: anahtar
açkıç: anahtar
açlık: açlık
açuksuz: açık olmayan, kapalı
agnidiş: (Sanskritçe agnideşa)
akasagarbı: (Sanskritçe Ākāśagarbha)
anagam: (Sanskritçe anâgâmin), öldükten sonra bir daha doğmama (samsara'dan kurtulma)
aŋmagad: (Sanskritçe angamagadha)
Aşvagoşa: (Sanskritçe Aşvaghosa), özel ad
Bagirati: (Sanskritçe Bhagiratha), özel ad
kadaglıg: günahkar
magad: (Sanskritçe magadha), bir şehir adı
magirt: bağırış
nomlaguçı: öğüt veren, öğreten, vaaz veren
bahşısız: hocasız, öğretmensiz
çahşapatlığ: hocalı, öğreticili
mahabala: (Sanskritçe mahābala), özel ad
mahabut: (Sanskritçe mahabhüta), büyük eleman
maharuk: büyük yılan
Aşivaçit: (Sanskritçe Aşvajit), özel ad
Atnakaudani: (Sanskritçe Ajnata Kaundinya), özel ad
praçapatı: (Sanskritçe prajāpati), bir şeytan adı
akanışt: (Sanskritçe akaniştha)
akanıştaparyan: (Sanskritçe akanişthaparyana)
akanişun: (Sanskritçe akanisth ~ akanisthika)
akıl-: akmak, (samsāra'da) yürümek
akıla-: ağlamak
akın: büyük ırmak, nehir
aksak: bkŋz; ağsak, aksak, topal
akşar: (Sanskritçe akşara)
akşobı: bkŋz; akşobi, (Toharca aksobhe), (Sanskritçe akşobhya), Akşobhya Buddha
akur-: yavaş davranmak
akuru: yavaş
amalaprabı: (Sanskritçe amalaprabhā)
amanç: (Sanskritçe amātya), bakan, zengin
ambar: (Sanskritçe ambara)
amğa: yaban keçisi
amo: (Aramice) Ammānuel'ın kısa biçimi, şahıs adı
amogaşırı: (Sanskritçe amoghaśrī)
amraklağu: sevilecek
amravan: (Sanskritçe āmravana)
amrık-: huzur bulmak
amrtapada: (Sanskritçe amrtapattra), bir ağaç adı
amvardişn: (Partça mwrdyşn), toplanma
ap...ap: her ne kadar, gerek...gerek, ister...ister, hem..., hem de
apandar: (Sanskritçe avatāra)
aparaçıtı: (Sanskritçe aparājita), bir şeytan adı
aparığ: sair
apıramanı: (Sanskritçe apramāna)
apramanab: (Sanskritçe apramânabha), tanrılar diyarı adı
apramanaşub: (Sanskritçe apramânaśubha), bir tanrılar diyarı adı
apramani: (Sanskritçe apramāna)
as-: çoğaltmak, (çok tekrar ederek veya ettirerek) alıştırmak, arttırmak, üstün gelmek
asağlağ: faydalı
asankılığ: sayısız
asaŋı: (Kuça dili asamkhyai), (Sanskritçe asamkhyeya), sayısız
asaŋılağ: sayısız
askya: azıcık
asrakı: alçak, basık, düşük
Astiramati: (Sanskritçe Sthiramati), özel ad
asut-: artırmak, çoğaltmak
aşok: (Sanskritçe aşoka), bir nevi ağaç
aşup: (Sanskritçe aşubha), pis, çirkin
ataç: sevgili ata
atakı-: meşhur olmak
atal-: adlandırılmak
atap: (Sanskritçe atapa)
atasız: atasız, babasız
atavakı: (Sanskritçe ātavaka), bir şeytan adı
atay: sevgi sözü
ataz: sulama kanalı
atım: savaşçı, nişancı, nişancılık, atıcılık
atıpur: (Sanskritçe) bir şehir adı
atız: titretmek, çınlatmak, telli bir çalgı çalmak
atka-: bağlamak
auu!: vay!
odhauh: uyanık
avantlığ: sebepli, nedenli
avantsız: sebepsiz
Avatı: (Sanskritçe) bir şeytan adı
avazasay: (Sanskritçe) gönlü ve karnı bozuk
avkan: (Sanskritçe avakan, avakhan, khavakan), bir şehir adı
avyat: utanma
azman: iğdit at
azrakça: pek az
anabarak: (Sanskritçe anabhraka) bir tanrılar diyarı adı
anuşayakoş: (Sanskirtçe anuśayakośa), Vasubandhu'nun Abhidharmakośa adlı eserinin 5. bölümünün adı
Balıkı: (Sanskritçe bhallika), bir tüccar adı
baradıvaçı: (Sanskritçe bharadvāja), bir şeytan adı
Çanarşabı: (Sanskritçe janarşabha), bir şeytan adı
indirayakoş: (Sanskritçe İndriyakosa), Vasubandhu'nun Abhidharmakosa'sının ikinci bölümünün adı
parıtaşub: (Sanskritçe parīttaśubha), bir tanrılar diyarı adı
paritab: (Sanskritçe Parittabha), bir tanrılar diyarı adı
prabangkarı: (Sanskritçe Prabhamkara), bir tanrılar diyarı adı
vaybaş: (Sanskritçe vaibhasika), bir mezhep adı
bıçğusuz:bıçaksız, bıçkısız, kesicisiz
bıçın: maymun
bır: burada, sağ taraf, güney
bırımçı: işkence edici
bısız: bıçaksız, kesici olmayan
bışığ: olgun, pişmiş, say eden
bışma-: pişmemek, olmamak, olgunlaşmamak
bışruntur-: olgunlaştırmak
bıtbul: (Sanskritçe pippala), bitmul biberi
atkanğu: bağlanacak şey, duyu organlarının dış nesneleri, duyu sahası, duyu objesi
bögteçi: hayırlı işler isleyen
bögteg: hayırlı iş
bögün-: derin düşünmek
bök-: bıkmak, usanmak
bökünki: bugünkü
bölök: bölük, küme
bölül-: bölünmek
bölün-: bölünmek
börisiz: düşmansız yagısız
böritig: temas
börit-: temas etmek
bra: (Sanskritçe pr), gölgelik, çardak
brt-: kırmak, parçalamak
tebrenç: sarsılma
bel: bel, kuşak, böbrekler, gövde
bügü biliglig: bilgelik sahibi, büyülü güce sahip, olağanüstü güce sahip kişi
bügülen-: tabiat üstü güç göstermek, büyülenmek, büyü bilgisine sahip olmak
bügülüg: hikmetli, dindar, inançlı
bügün-: vakıf olmak, tanımak
alkatmış: bereketli, mübarek, mübeccel
trapuşı: (Sanskritçe trapuşa), bir tüccar adı
alpa-: cesur olmak
çerik: cengaver
sığıtçı: cenaze alayı
şarırlığ: cenazeye ait, arta kalan şeylere ait
titim: cesaretli
titimlig: cesaretli, cesur, kahraman
çık: (Sanskritçe ch'i), kadem (uzunluk ölçüsü)
çodaki: (Sanskritçe codaka), sorucu, itirazcı
esirkençsiz: esirgemeyen, cömert, (bir şeyden) kaçınmayan
alar-: cüzzamlı olmak
ala ala: alaca, cüzamlı, cüzam
huilip: (Çince Hui-li), Hüangtsang'ın tercüme halini yazan kimse
pirapti: (Sanskritçe prāpti), kazanma, her şeyi kazanma gücü, her yere girme
birdemleti: tam olarak, tam, hiçbir zaman, asla
kaçanıŋ: hiçbir zaman
içdin: iç, içeri
çebiş: oyun, kurnazlık, hile, çare
çekik: toygar kuşu, tarla kuşu
çelk-: yol göstermek, yöneltmek
biçge: bıçak
sıçğanak: adele, kas
çıbık: çubuk
çıgany: yoksul
çığarı: çıkrık, dokuma çıkrığı
çımbudbıp: Hindistan'ı da içine alan efsanevi Jambudvipa ülkesi
çınarçeçek: bir tür çiçek
çınsız: gerçek olmayan, yalan, gerçek dışı
çıntan: (Sanskritçe candana), sandal ağacı
çıpık: budak, dal
çikin: ibrişim
tançkala-: eti parçalamak, kesmet, ditmek
erkeçlen-: teke doğurmak
örküçlen-: dalgalanmak
tegzinçlig: devirli, dönmeli
öçme-: sönmemek, yok olmamak
öçmeksiz: sönmesiz
kaçnaŋ: nitekim, nasıl ki, ne türlü
kaçnaŋneŋ: ne türlü şey
çolmaksız: ızdırapsız, sıkıntısız, öfkesiz
ançola-: dini törenle kutsamak, takdis etmek
ançolasık: böyle yapmaklık
çöket-: diz çökmek, çökmek, çökertmek
çözül-: çözülmek
neçök: nasıl, neden
sasılık: çöp kovası
seşil-: çözülmek, ayrılmak, birliği bozulmuş olmak
seşilme-: çözülmemek
içreki orun: harem, iç daire
içreki orunçı: saray memuru
balıŋla-: birden korkup sıçramak, vuykuda korkup sıçramak
adıçtıt: (Sanskritçe ādicitta)
çuba: elbise
çubakan: bir çeşit bitki
çulbu: hakaret, küfür
çulvusuz: sözvgüsüz, küfürsüz, ayıglamaksız
çügte: kulağın arkasındaki kemik
ukunçsuz: tedbirsiz
arśi: (Soğdca rizai), (Sanskritçe rsi), evliya, münzevi
patğamwar: (Soğdca patğambar), peygamber
antaddatta: ondan
nedde ötrü: neden ötürü
buyan edgü kılınç: iyi davranış, iyi amel
adğak: zincir, pıranga, kelepçe
kadğusuz: kaygısız, dertsiz, üzüntüsüz
kadhaş: akraba, dost, birader
odhon-: uyanmak
uladhi: ve, ve daha, vs
anurad: (Sanskritçe anurādhā), bir takım yıldızın adı
anuriti: (Sanskritçe anuruddha)
aranyadan: (Sanskritçe āranyadhānī)
Badarı: (Toharca Padhari), (Sanskritçe Badhari), özel ad
adkan: (bir şeye) bağlanmak, tutkuyla bağlanmak, yapışmak, bırakmamak, elde tutmak, korumak
adkanğuluk: bağlanılan, bağlanmılması gereken, (Sanskritçe grâhya)
üdki: vakit, vakte dair, vakitteki
budla: deve burnuna geçirilen halka
edliksiz: yoksul, değeri olmayan
üdlüg: zamanlı, zamana ait
titme: denilen, denen, diye adlandırılan, yani
busrul-: kederlendmek
ıdok: kutsal, kutlu, aziz
ağtar-: dönmek, çevirmek, karıştırmak
törtegü: dört, dördü, dördü birlikte
törter: dörter, dört
adrı: çatal
adrılmaklığ: ayrılma
adrok: uygun, iyi, hoş, farklı, çeşitli, ayrı
adroksuz: eşsiz, benzersiz, emsalsiz
adrud-: bkŋz; adrutmak
adrukrak: daha artık, mükemmel
adruksuz: farksız
adrul-: ayrılmak
Artadrş: (Sanskritçe Arthadarşin), özel ad
Badrı: özel ad
bodsuz: biçimsiz
eşidsiç: Maniheizmde dinleyici
üdsüz: zamansız
ıdtur-: koyuvermek, salmak, bırakmak
seb-: sevmek
egil: uzman olmayan, din adamı olmayan
eginsiz: çatısız
egrikşel (e) -: fır fır dönmek, etrafta girdaplar oluşturmak
ertük'teğ: olduğu gibi
ilinçü: eğlence, gezinti
ilinçüle-: eğlenmek, oynamak
ilinçülegü: eğlenme
ilinçülegülüg: eğlence, eğlenceli
bi: (Çince pei), yazılı taş
eksüklüg: eksik, tamamlanmamış
ekindi: ikinci
ekki: iki
ekkigü: ikisi, ikisi bir arada
ekkileyü: bir kez daha, ikinci kez, yeniden
ekkinti: ikinci
ekşi-: ekşimek, kızmak, acı duymak
ekşig: ekşi
elik: erkek ceylan
ellig: hünkar, kral, devlet başkanı
emgetir-: emek vermek, eziyet etmek
emik: meme
emiş-: emmek
emlet-: ilaç vermek, iyileştirmek
emrenç: (Sanskritçe şreşthi), zengin
en-: inmek
enç: rahat, huzurlu
enig: fena, yaman, hasta
entak: böyle, böylece
entür-: araştırmak, aramak
esenim: sağlıkla, salimen
esenlig: sağlıklı
esirke-: merhamet etmek, acımak, yakınmak
esiz: nida, ah?
esne-: esnemek
eşgek: eşek
eşittür-: işittirmek, duyurmak
eşil-: azalmak
eşitil-: işitilmek
etayu: anmak, çağırmak, ünlenmek
etiglig: süslü, bezeli
etigsiz: süzsüz
etizdür-: çınlatmak
eyem: takip etmek, dolayı, sıra
neŋeyü: ayrı
Ay!: Ey!
üçürgü: eyer keçesi
ezüg: sahte, yalan
ezügçi: yalancı, hilekar
ezügle-: yalan söylemek, kandırmak
ezügsüz: yalansız, doğru
bezek: süs, bezek
ermez: olmaz, değil
ançıp: fakat, ama
adınç: fevkalede, seçilmiş, başka türlü
sığda-: feryat etmek, ağıt yakmak
ağızlan-: telaffuz etmek, konuşmak, söylemek
baya-: müreffeh olmak, zenginleşmek
boşa-: kurtarmak, affetmek
biir: (Çince pi), yazı fırçası
yaŋa: fil
övkelemeksiz: öfkelenmeden
arva-: okuyup üflemek
iŋgü: mafsal, eklem
çasutla-: iftira atmak
ıntın: öte bulunan, karşı tarafta olan, öbür taraftaki, öte yandaki
ondın: ön taraftaki, ön taraf
sıŋarkı: taraftaki, yöndeki
sıŋardınkı: taraftaki
erklik: nüfuz sahibi, hükümdar
yalpırgak: yaprak
aŋan-: gaspetmek
erigçi: gardiyan
inle-: gasbetmek
şanduŋ: (Çince shan tong), Huangbo nehri dirseğinin doğu taraf
aryasaŋ: (Sanskirtçe āryasangha)
seŋrem: (Sanskritçe sangharama), manastir
arıglıg: temiz, arı
beglik: bey olacak, bey olmaya layık
eriglig: öğütlü, nasihatlı
iligle-: elle tutmak, eline almak, kavramak
neglük: peki niçin, ama neden, hangi nedenle
imrerigme: çevrilmiş, kuşatılmış
udıgma: uyuyan
ağnikişi: (Sanskritçe agnikeşa), şeytanlardan birinin özel adı
ağnitiş: yer adı, bkŋz; agnidiş
bugra: erkek deve
bugralık: buğralık, buğra olmaklık
ögret: temrin, itiyat, alışkanlık
begsig: bey neslinden
bitigsiz: kitapsız
işidigse-: işitmek istememek, reddetmek
sevigsiz: sevimsiz
ülügsüz: nasipsiz, kısmetsiz
ürlügsüz: daimi
altıgu: altısı
ağdıl-: yükseltilmek
ağduk: kusurlu, çürümüş, harap, bozuk, aşağılık, yabancı yerden gelip katılan, fena, garip
ağdur-: ağgırmak, yükseltmek
bağdaşın-: bağdaş kurmak (budistler gibi), paryanka duruşunda oturmak
katığdı: sıkı, sıkıca
toğdı: kişi adı
birtin: sağ, güney, sağdaki
birtinki: sağdaki
alğil: al, alıver
ağmaksız: değişmez, sarsılmaz, kalıcı, baki
tapunuğma: tapınanlar
bertet-: vurarak sertleştirmek, çiğnemek, vurarak yoğun ve sıkı bir hale getirmek
iŋle-: burgu gibi dönerek ezmek, çiğnemek
orkun: kuzey Moğolistan'da ve Sibirya'da Hangai dağlarından kuzeye akan Orhon Nehri
ağrığsız: hastalıksız, dertsiz, ağrısız, sızısız
ağruklan-: ağrılanmak, hastalanmak
adınsığsız: değişmez
alığsız: alışsız, almaşız
altağsız: hilesiz, yalansiz
oğşançığ: benzeyen
oğşat-: benzetmek
oğşatı: benzer
oğşatığ: benzer
oğşatığsız: benzersiz
katığtı: sıkıca
humaru: teselli, son öğüt, vasiyet, miras
ağzanmış savığ: söylenmiş söz
hağan: kağan
hatal-: birleşmek, katılmak
haymavatı: (Sanskritçe haimavata), bir şeytan adı
bağatur: bahçe, bağ, çıkın, paket
hısğaç: kısğaç
almır: hırs
pardan: (Sanskritçe pradhana), esas nesne veya şahıs, en üstünü, en mühimi
sıŋku: şahıs adı
hiar: (Turfan yazmalarına göre) hiyar, yardımcı, dost
al altağ: hile
alsız: hilesiz
isirkem-: tamahkarlık yapmak
münlüg: günahkar
adasız: tehlikesiz, tehlike içinde olmayan, sağlam, sıkıntısız, tam, bütün
ağıt-: çevirmek, (gözleri, kafayı) ayırmak, birini tehlikeden korumak, kovmak
satğın al-: kurtarmak, bir pahasına başka bir nesneyi tehlikeden kurtarmak
sımta-: ihmal etmek
tümge: zayıf, ağır, akılsız, ahmak
hormuzta teŋri: hormuzta tanrı
ohol: oğul, çocuk
balığ: yaralı, bağlı, mahpus
hualan-: çiçeklenmek
lanhua: (Çince) lotus çiçepi
hüküm: yığın halinde
erksinme: hütmetme, hakim olma
ilçii bilge: hükümet adamı
illig: hükümdarlı, devletli
tapak: hürmet, hizmet
yükündür-: hürmet ettirmek
artağ: mahvolma, bozuk, yıkık
bosuş: mahzun, kederli
ançakıa: azıcık, bir az
ançakaya: azıcık
başlağlığ: başlangıcı olan
buzulmaksız: sağlam, bozulmayan, kalıcı
ıdukluk: kutlu, kutluluk
ağızlıg: ağızlı, konuşkan
altağlıg: hileli, yanıltmalı, aldatmalı
arslanlıg: aslanlı
bişbalıklıg: beş balık şehrinden olan
burkanlıg: burkana ait
nomılıg: öğretili
taŋkarıg: adak
yalıg: güler yüzlü, neşeli, şen
yaltırıg: parlaklık, cila
iyinki: arkasından gelen, sonraki sekiz on türlüg nayrag atlıg
adırtlığ: açık, ayrıntılı, kesin, farklı, ayrımlı, belirgin, vazıh, ayrıntılı
ıkarakşa: (Sanskritçe ekarakşā), bir tanrı kızı adı
ıkıla-: ağlamak, inlemek
ıladıvı: (Sanskritçe ilāevī), bir tanrı kızı adı
ınantur-: inandırmak
ındrı: bir şeytan adı
arka kılıp: araya ayrılık sokup
neçükle-: nasıl yapıp yapmak
ıra-: kaçmak, uzaklaşmak
ırat-: uzaklaştırmak, ıraklaştırmak
ırşı: (Sanskritçe īrşyā), peygamber, bilge kişi, aziz
ırşısız: peygambersiz
ısırka: köşk, saray
basutçısız: yardımcı-sebepsiz
ışanı: (Sanskritçe isāna), bir şeytan adı
ıta: yok olma, ne yazık, boşuna
ıtız: titretmek, çınlatmak
ıvatı: (Sanskritçe revatī), bir takımyıldızı adı
vibakti: (Sanskritçe vibhakti), hal eki, hal
öpgük: ibidik, hüthüt kuşu
içiŋe: içine
içsire-: tedirgin olmak, rahatsız olmak
ideriş-: birini takip etmek
iderişdür-: birini takip ettirmek
idisiz: sahipsiz, sahibi bilinmeyen
igizsiz: yalansız, yanlışsız
igir-: yetiştirmek
igirt-: yetiştirmek
iidi-: toplamak, derlemek
iiş: eş, arkadaş, yoldaş
padak: (Sanskritçe pādaka), ifade, tarz, şiir, koşuk
ikisiz: tek, bir, iki olmayan, şüphesiz, kesin
iktüle-: bakmak (hastaya veya çocuğa)
ild-: iletmek
ilenmeksiz: ilişiksiz
ilgek: kanca
ilildür-: birbirine bağlamak, ilindirmek
imre-: dilemek, arzulamak
in: hayvan yuvası, in
inçetip: şöylece, şöyle diyerek
pataliputurta: bir şehir adı
vipaşı: Özel ad
is-: el koymak, gaspetmek
isen: sağlam, sulh
isirke-: esirgemek, merhamet
iske-: ditmek, elle küçük parçalara ayırmak
işil-: azalmak
işleş-: çalışmak, çalışığ çabalamak
işlig: işli
itiz: yüksek
iyesiz: sahipsiz
oŋarıl-: iyileştirilmek, onarılmak
izgil: muhtemelen Oğuz kabilesinden bir boy adı
çambu: (Sanskritçe jambu), elma
Çayantı: (Sanskritçe jayani), bir tanrı kızı adı
erkçe: erkekçe, kuvvetlice
erü erü: yavaş yavaş, gitgide, gittikçe
birikdür-: biriktirmek, birleştirmek
birükdür-: birleştirmek
birgert-: bir araya getirmek, birükdürmek
kandırakobındı: (Sanskritçe khadirakovida), bir şeytan adı
pançaşiki: (Sanskritçe pançaşikha), gökte bir mızıkacı
balıkkaya: küçük şehir
kadukkin: sabit
çawıkmış: meşhur
ükmek: yığın halinde
Sakntili: (Sanskritçe Skandhila), özel ad
bodapakşik: (Sanskritçe bodhipakşika), Budalık için aşılması gereken 37 şart
bükşil-: yarılmak
biriktür-: biriktirme, birleştirme
sıktaş-: ağlaşmak, birlikte feryat etmek
şakti: (Sanskritçe şakti), mızrak
uktur-: anlatmak, açıklamak, izah etmek
lank: (Sanskritçe lanka), bir şehir adı
yalbarmaklığ: yalvarmaklı, yalvaran
aldın: alt, aşağı
bildür-: bildirmek, anlatmak
leśp: (Toharca Kuç), vücudun üç özsuyundan biri
belgülük: görünür, aşikar, belirli, tanınan
belgürtme: belirmiş, yeni bir vucula ortaya çıkmış, vucut bulmuş, belirtme, gösterme, açık hale getirme
belgürtme et'öz: görünen vucut
belgüsiz: işaretsiz, alametsiz
bilge bilig: bilginin yükseği, irfan, kemal
bilgülük: bilinecek, bilinmesi gerekli, bilinesi
ülgülegülüksüz: sonsuz, hudutsuz, ölçüsüz
ülgülüg: ölçülü, belirli, ölçüde
alğan: alınmış (kocaya varmış kadın)
alğan-: övülmek, ünlenmek
bolğuçı: olan
uğayu: bilhassa, özellikle
adı kötrülmiş: iktidar sahibi
aŋulmali: (Sanskrirtçe angulimalya)
bitilmiş: yazılmış
bolmaklığ: olma, olmak, olmaklı
bulma-: bulmamak, elde etmemek
talma-: talan etmek, parçalamak
bodısabat: (Sanskritçe bodhisattva), Buddha düzeyine erişmesine yalnızca bir basamak kalan Buddhacı aziz
alokaçıntamanı: (Sanskritçe ālokacintāmani)
olor-: oturmak, durmak, oturmak
alpal-: yiğitleşmek
yalpırğaklığ: yapraklı
yüreklig: gönüllü, kalplı
ilsire-: yersiz olmak, memleketsiz olmak, ilsiz olmak
ilsiret-: yerinden mahrum etmek
adınçsız: eşsiz, benzersiz, emsalsiz
ağın: dilsiz
tözsüz: temelsiz, köksüz
alaŋkarkalvani: (Sanskritçe alamkârakalyâna)
kalvink: (Sanskritçe kalavinka), güzel sesli kuş
alaŋkarakalyanı: (Sanskritçe alamkārakalyāna)
bimba: (Sanskritçe bimba), Bimbasāra adının ilk parçası
Bimbasari: (Sanskritçe bimbasāra), özel ad
yumburu: yumru, sıkıştırılarak top haline getirilmiş
baka: kaplumbağa, tosbağa
sari: (Sanskritçe sāra), Bimbasāra'da ikinci unsur
basutçılığ: yardımcı-sebepli
birgese-: kamçılamak istemek
vayşıravanı: (Sanskritçe vaisravana), bir hükümdar tanrının adı
yügerüki: şu anki, şimdiki
tamğaçı: damgacı
tamka: damga
sıkı: (Sanskritçe simha), bir şeytan kumandanının adı
sınhabalı: (Sanskritçe simhabala), bir şeytan adı
çamkuy: (Çince çam-huy, ts'am-huai), pişmanlık, nedamet
ağır ayamak: pek ciddi, ağırbaşlı, temkinli
şankara: (Sanskritçe samkara), bir şeytan kumandanının adı
birdemlig: tam, tam olarak
kanımlığ: han olmaya layık
serimlig: sabırlı, yumuşak başlı, hoşgörür
toğumlu: doğum
sergü: tahammül
pramodadı: (Sanskritçe pramodā), bir tanrı kızı adı
bou: (Çince wu-mou), 10 Kan'dan beşincisi
çampay: (Sanskritçe campa), bir şehir adı
semrit-: semirmek, semirtmek
yamraş-: karışmak
buyur-: emretmek, buyurmak
samsara: ruhun bir bedenden başka bir bedene geçip yeniden doğması
adak kamşat: isyan çıkarmak, karışıklık çıkarmak
ersin: tokuz ersin, Tibet'in komşusu bir halk yada yer adı
yamtar: ışbara yamtar
müŋüz: boynuz
şıravan: (Sanskritçe sravanā), bir takımyıldızı adı
şarmiri: (Kuçaca sarmire), rahip namzedi
Nağa-arçuni: özel ad
nara nara: bir şeytan adı
nayvazik: (Toharca naivaśik), cin
birdin: birdenbire, ansızın
ne üçün: niçin
nede ötürü: neden ötürü, neden dolayı, ne suretle
nelüg: ne diye, ne olarak
netegin: neden, niçin, nasıl
netegleti: nasıl olur da
erksingü: güçlü, kuvvetli
atkanğular: hisleri rapteden (altı bağ), hisse mevzu teşkil eden harici varlık, (Sanskritçe vişaya)
atkanğuluğ: kelepçeli, bağlı
ağlak: yanlız, terk edilmiş, tenha, ıssız yer
anmaklığ: uz
aŋmıntın: hatta, kuvvetleştirme, üsteleme
erksinmeklig: yetkili
ilinme-: takılmamak, ilişmemek, yapışmamak, bağlanmamak
kanmaksız: kanmaksızın
katığlanmaklığ: azimli
tanmış: inkarcı
pratikanarak: (Sanskritçe pratyekanaraka), cezası az bir cehennem
tapn: (Sanskritçe tapana), bir cehennem adı
puranprabı: bir buddha adı
arığ teŋrim: mukaddes tanrım
öŋreki: önceki, daha önceki, evvelki
boyunsuz: boyunsuz, başsız
ornat-: yapmak, inşa etmek, bir yere göçmen yerleştirmek
bodimant: (Sanskritçe bodhimanda), tenvir tahtı
Burua Ğuru: (Sanskritçe purvaguru), bir isim yada ünvan
sad: batı Türklerinde kağandan sonra en yüksek unvan
punyaparsab: (Sanskritçe Punyaprasava), bir tanrılar diyarı adı
oduntur-: uyandırmak
oğlum: oğulum
olan: oğlan
olarka: onlara
olarnı: onları
olurt-: tayin etmek
otom-: uyanmak
boo: bu
orı: erkek, genç
orna-: bir yere konup kalmak
ornaŋu: ikametgah, yerleşilen yer
ortunkı: ortadaki
otaçılık: çadır yeri, yerleşecek yer, mesken
otğurakla-: kesinleştirmek
otğuraksız: belirsiz, kesin olmayan, güvenilir olmayan
otğuratı: tam anlayarak
otkurak: inanılır, güvenilir
otırakı: ortadaki
oyma er: oyuncu
oyma: oyucu, sakatat çıkarıcı
boymul: bir tür doğan
toyğun: yüksek bir rütbe
bozul-: bozulmak
intin: öbür
ödüre: adıra ödüre, öteye beriye
ödürt: ayırt etme, fark etme, farklı olma, ayrılma
ödürtlüg: doğru, tamamıyla
ödüş-: geçmek
tödüş: kavga mücadele
örget-: öğretmek
Töliş: Türk devletlerinin doğu kısmı
öŋin: başka, farklı
öŋün: ön, ev önü
öni: başka, -den başka, farklı
şöö: (Çince shi), ordu
Töpüt: Tibet
satu: (Sanskritçe setu), köprü
örden-: yanmak, tutuşmak
örgen-: kirlenmek
öritdür-: yükselttirmek, yetiştirtmek, yükseltmesini sağlamak
öritgüçi: uyandıran, örütici
örit-: yükseltmek, besleme yetiştirme, ortaya çıkarma
bük: köşe
özke: başka
padumı: (Sanskritçe padumā), bir tanrı kızı adı
pançamantal: (Sanskritçe pança-mandala), beş uzuv, vücudun beş üyesi
pariçatr: (Sanskritçe paricitra), gökte güzel kokulu bir ağacın adı
parmanu: (Sanskritçe paramānu), atom, toz, zerre, küçük parçacık
paru: bir şeytan adı
paşaŋ: (Sanskritçe pasanak), bir dağ adı
paşantak: (Sanskritçe pasandika), din yolundan ayrılan, zındık
paşdanak: koruyucu, hami
patal: (Sanskritçe patali), çiçekleri güzel kokulu bir ağaç
tapça: kir, pislik, çamur
atkak: bağ, kelepçe
atkaklığ: bağlı, kelepçeli
periken: peri
irpeş-: karşılıklı birbirini kesmek
Arpı: (Sanskritçe) bir şeytan adı
tapınçı: hizmetçi
tapırtsız: hareketsiz, kımıltısız, sakin, sessiz
Anatapintiki: (Sanskritçe Anathapindika), özel adı
kapkara: kapkara, simsiyah
taplançsız: istenilmeyen
poşı: bağış, sadaka
poşıçı: bağış isteyen, dilenci
pratityasamutpadi: (Sanskritçe pratityasamutpada), sebebe bağlı bir şekilde doğuş
prnadasunu: (Sanskritçe pranadaşunu), bir nevi istiğrak oturuşu
prştaka: (Sanskritçe prştaka), bir şeytan kumandanının adı
saprir: mücevher, bir taş, kıymetli
kapşur-: katlamak, bir araya koymak, kavuşturmak
anabataptı: (Sanskritçe anavatapta)
anavataptı: (Sanskritçe anavatapta)
anubatat: (Sanskritçe anavatapta)
ertdür-: geçirtmek, yaptırmak
muntuz: geri zekalı, aptal, şaşkın
pundarıka: (Sanskritçe pundarīkā), bir tanrı kızı adı
pundarıkı: (Sanskritçe pundarika), bir şehir adı
purvaşad: bir takım yıldızı adı
arçışmatı: (Sanskritçe arcismatī)
anı barça: hep onu
ardir: (Sanskritçe ardra), ayın menzillerden biri, bir yıldız adı
karğantı: beddua, lanet
arhant: (Sanskritçe arhant), aziz, veli, kutlu kişi, ermiş
burhanlığ: kutsal, ilahi
tirnegül: toplayan
yanar erŋek: işaret parmağı
bürkür-: su serpmek
ağırrak: daha ağır, çok ağır
Arşidati: (Sanskritçe Rsidatta), özel ad
sakirtağam: (Sanskritçe skrdagamin), Nirvanadan önce bir defa daha gelecek olan
sartbav: (Sanskritçe sārthāvaha), kervan başı, kılavuz
anantaraş: (Sanskritçe ānantarya)
bilerzük: bilezük
antaran: büsbütün
şaniçar: (Sanskritçe sanaiscara), zülal gezegeni
üsdel-: çoğalmak, artmak
üsdünki: üst, üstteki, yukarıdaki
busğak: yürek sıkıntısı, nefes darlğı
tanuklat-: kanıtlanmasını sağlamak, kanıtlatmak, tanıtlatmak, ispat ettirmek
kamaşırıştı: (Sanskritçe kāmasreştha), bir şeytan adı
şarada: (Sanskritçe sraddha), bir tanrı kızı adı
ağastı: (Sanskritçe agasti), bir dağ adı
süŋüş: muharebe, savaş
samadi: (Sanskritçe samādhi), istiğrak, meditasyon
şala: (Sanskritçe śalā), bir cins ağaç
şalavan: yer adı
şankı: özel ad
şaşan: (Sanskritçe sāsana), disiplin, akide
töke-: işba haline getirmek
taşdırtı: dışarıda
bişegü: beşi
bişer: beşer
boşğutsuz: (Sanskritçe şaiksa), öğrenmeyen
şırı: bir tanrı kızı adı
başka: başka
yaşo-: parlatmak, cilalamak
birişsiz: verişsiz
adıştılığ: kaderli
alıştur-: aldırmak
Çaştani: hanın adı
tüşürül-: düşürülmek
bişyüz: beş yüz
şzn: (Sanskritçe şaşana), din, akide
adutça: avuç avuç, avuç dolusu
bütgüsüz: bitirilmemiş, tamamlanmamış
ertgür-: geçirmek
satğın: satın
yumurtğa: yumurta
anaz: (Sanskritçe anātha)
sıdartı: (Sanskritçe siddhārthā), bir tanrı kızı adı
atkaksız: bağsız, özgür
atkançsız: bağsız, serbest
altmışar: atmışar
arıtmaklığ: temizlenme, arıtma, yıkanma
batma-: batmamak, yok olmamak, gizlenmemek
bütme-: bitmemek, tamamlanmamak, sona ermemek, olgunlaşmamış olmak
katna-: tekrar etmek, tekrarlamak
arttok: artık, fazla, ziyade
tutyaksız: varlığa bağlanmasız
ubat-: inceltmek, parçalamak, ufaltmak
bultaçı: bulucu, bulan, -e nail olmak
batutlug: gizli saklı olan
bokün: bugün
uğrayu: özellile, tamamıyla, tam olarak, tamamen
uğura-: uymak, planlamak, niyet etmek
uk-: anlamak, öğrenmek, bilmek, kavramak, tasavvur etmek
ukıt-: anlatmak, bildirmek, açıklamak, izah etmek
ukul-: anlaşılmak
ukun-: itiraf etmek, bilinmek, tanınmak, anlaşılmak
ukuş: benzeyiş, soy, kabile
ulayu: dahi, ve
ulun: sap
uma-: yapamamak, yetersiz olmak, muktedir olmamak
Tuuğ: bayrak
uvutluğ: edepli
uzun turkaru: mütemadiyen
alaçuk: kulübe
anı üçün: onun için
üd: zaman, vakit, çağ, devir, dönem
üdrül-: seçilip ayrılmak, ayrılmak, seçilmek
üdün: zaman, vakit
ertüdin: tamamıyla
yüdül-: yüklenmek
boğ: küf
ügli-: çoğalmak, büyümek
erat: erkeğin bülüğ ismi
ümele-: konuk olmak, konukluğa gitmek
üŋüş-: delinmek, yırtılmak, yolunmak
ünlüg: kalaplı, ünlü, adıyla tanınan
ünsüz: sessiz, sedasız
ünte: ünlemek, çağırmak, seslenmek, sesini yükseltmek
ünüş: yükselmek, çıkış
ür keç: er geç
ürgür-: vaktinde yetişmek, vaktinde gelmek
ürlüg: sabit, değişmez, daima
ürüg: uzun müddet, uzun süre, sürekli
ürüŋ: beyaz
ürüŋtesiz: ilaç
büyülen-: bilme
üzelenü: yüksek
üzük: kesik
üzüş-: kırmak
vadı: (Sanskritçe vadi), bir şeytan adı
vastu: (Sanskritçe vastu), madde
tölit: yatak takımı, yastık vb
sever: sevgili
birgeli: vermek için, vermelik
ertinilig: mücevherli, mücevherle bezenmiş, süsleniş
savla-: konuşmak
e: ünlem, seslenme durumu, vokatif, ey!
ayduk: söylenmiş
çaydan: mabet
ayğ: söz
buymul: bir çeşit kuş
bir teg: aynı, benzer
al çeviş: yol - yordam, yöntem
ayt-: sormak
aytığ: soru, sorgu
aytığ bol-: sorguya çekilmek
aytıŋ: ay ışığı, mehtap
çaytir: (Sanskritçe citra), bir yıldız adı
arası: (Sanskritçe) bir şeytan adı
arkon: zulmet şeytanı ve tali şeytanlar
Badar: (Sanskritçe) bir şeytan adı
yyü: yemek
ağızan: konuşmak
kakası avazasay: gönlünü ve karnını bozmak
kanığ: gözde
katığsız: karışık olmayan, düzgün
biziŋ: bizim
biziŋe: bize
ağazla-: söylemek
bedizle-: süslemek
bizniŋ: biz zamirinin ilgi hali, bizim
yazok: kötü davranış, günah
katığla-: yormak, germek, zorlamak
tak: sızıntı, zorluk, rahatsızlık
yalabaç: elçi
ini içili: kardeşle ağabey
tögi: kabuğu çıkarılmış darı
iŋir: alaca karanlık
kaçığlığ: duyu organı olan
sakıntaçı: bir niyet besleyici, niyetli, istekli
yalavaçı: elçi
İtaçuk: özel ad
adağırlık: yılkı, hara
adart-: zarar verme, engelleme, engel olma
adayı: yavru
adıkarmıkı: (Sanskritçe ādikarmika)
arığ dintar: gerçek din hadimi
çadak: bkŋz; çadik
yadrat-: yere yatmak, yatırmak, yere sermek
aduğun: at sürüsü
adur-: ayırmak
taŋlar-: tan atmak, şafak sökmek
ağad: (Sanskritçe agada)
ağaru: (Sanskritçe agaru), bkŋz; agar
toğara: (Sanskritçe tagara), bkŋz tagar
Biregiki: (Sanskritçe Vairagika), özel ad
ağar ayağın: derin hürmetle
ağatı: (Sanskritçe Āgata)
kağansıra-: kağansız olmak
ağır ayığ kılınç: kötü amel, fena davranış
ağırlamaklığ: saygı gösterme, saygı göstermekli, ayamak
kamağlığ: bütün, tüm, kamuya ait
ağ-: ağmak, yükselmek, binmek, çıkmak
bağrağu: sadaka dilenme
ilinçsiz: bağsız, ilişkisiz
samir: (Sanskritçe sumeru), kainatın merkezi, bir dağ
çaişi: (Çince) rahip yemeği
çakar: (Sanskritçe çakra), tekerlek
çakir: (Sanskritçe çakra), tekerlek, çark
bayumaklığ: zengin olma
artamaksız: bozulmayan, çürümeyen, sağlam, dayanıklı, bozulmaz
ayığlamaksız: kötülemesiz
kadaksız: kusursuz, hatasız
bokay: alçak, basık, düşük
yalım: yalçın
yalınç: alev, yalım, parıltı
alığ: alış, alma
arlı: çatal, çatallı
alt: alt, altta, alttaki, aşağıdaki
alta-: kandırmak, aldatmak
altız-: yitirmek
ançama: bu kadar, bunca
bamak: bağlanmak bir üze birer baŋ
bekü-: sağlamlaşmak
büt: binmek, tamamlamak
tiriŋ: derin, derin anlamlı
yamuz: böğür, yan
bütüt: ikmal, tekamül
Ananta: özel ad
ananto: (Sanskritçe Nalada)
anaŋ: onun, bkŋz; anıŋ
anapana: (Sanskritçe anapana), ruh
anar: onlara
baz: yalancı, barışık, sakin
ançan: derece
kandın: nereden
kandur-: tatmin etmek, kandırmak
yanduru: tekrar, geri
bakır: bakır para, mangır, bakır kızıl
anılayu: bu şekilde, bu tarz, böyle
anımışa: (Sanskritçe animişā), bir tanrı kızı adı
anıŋ arasınta: o sıralarda
anıt-: devam etmek
anko: (Çince an ku)
aŋlağ: akıllı, zeki, anlayışlı
anta ötrü: bunun üzerine
antın: oradan, ondan sonra
antıray: (Sanskritçe antarāya)
antiris: bkŋz; anantris, günah
antran: oradan
tapağ uduğ: bakım, koruma
tapavan: (Sanskritçe tapavana), inziva ormanı
yapak: kapak
sakışlığ: sayılı, ölçülü, hesaplı, belirli bir sayıda
arkuru turkaru: enine boyuna, çapraz
beklel-: hapsolmak, bağlanmak
tapun-: tapınmak
arağ: temiz
aram: (Hintçe) birinci ayın adı
arasız: doğrudan, direk, arasız
arığ semek: çay, çay kıyısı, ark
arığ simek: orman, koruluk
arığ tegin: özel ad
arığ tigin: özel adı
arıma-: temiz olmamak, saf olmamak
arkalığ: yardım, destek, destekli, arkalı
arkan: nihayet, son
barklığ: evli - barklı
barma yıl: geçen yıl
arsayın: (Sanskritçe rasayana), iksir iç
Bars: özel ad
bukarsı: bağ
artok: çok, fazla, pek
bart: zarar
aru-: yorulmak
arukla-: dinlenmek
sasağ: pis koku
basınçsız: baskısız
basındur-: ezilmek
baz-: basmak
basutla-: desteklemek, yardım etmek
başın: başta olmak üzere
katkı: sert, katı, haşin, şiddetli
başlayu: başta, baş olarak, ilk olarak
başlayuça: ilk olarak
atrıl-: ayrılmak
katrun-: katılaştırmak, kuvvetlendirmek, cesaret vermek
boşurkan: rahatsiz hissetme, kendini kusurlu rahatsız saymak, kaygılanmak
botu: deve yavrusu
ayançsız: korkusuz
ayaş-: karşılıklı saygı göstermek
ayığlaş-: kötüleşmek, düşman olmak
ayık: nezir
